,Statecode,Districtcode,VillageCode,Population,Males,Females
0,21,385,2553300,401,198,203
1,21,385,2553400,76,34,42
2,21,385,2553500,0,0,0
3,21,385,2553600,0,0,0
4,21,385,2553700,0,0,0
5,21,385,2553800,0,0,0
6,21,385,2553900,0,0,0
7,21,385,2554000,0,0,0
8,21,385,2554100,75,38,37
9,21,385,2554200,0,0,0
10,21,385,2554300,842,435,407
11,21,385,2554400,268,163,105
12,21,385,2554500,0,0,0
13,21,385,2554600,157,81,76
14,21,385,2554700,12,3,9
15,21,385,2554800,0,0,0
16,21,385,2554900,20,11,9
17,21,385,2555000,365,182,183
18,21,385,2555100,77,38,39
19,21,385,2555200,0,0,0
20,21,385,2555300,15,5,10
21,21,385,2555400,661,344,317
22,21,385,2555500,133,58,75
23,21,385,2555600,290,144,146
24,21,385,2555700,258,130,128
25,21,385,2555800,0,0,0
26,21,385,2555900,19,9,10
27,21,385,2556000,115,56,59
28,21,385,2556100,137,69,68
29,21,385,2556200,205,114,91
30,21,385,2556300,361,188,173
31,21,385,2556400,28,14,14
32,21,385,2556500,13,9,4
33,21,385,2556600,25,11,14
34,21,385,2556700,143,75,68
35,21,385,2556800,68,33,35
36,21,385,2556900,100,49,51
37,21,385,2557000,0,0,0
38,21,385,2557100,18,9,9
39,21,385,2557200,12,5,7
40,21,385,2557300,83,43,40
41,21,385,2557400,147,76,71
42,21,385,2557500,299,110,189
43,21,385,2557600,160,83,77
44,21,385,2557700,241,118,123
45,21,385,2557800,172,86,86
46,21,385,2557900,389,209,180
47,21,385,2558000,49,25,24
48,21,385,2558100,154,84,70
49,21,385,2558200,685,432,253
50,21,385,2558300,210,114,96
51,21,385,2558400,87,43,44
52,21,385,2558500,0,0,0
53,21,385,2558600,51,21,30
54,21,385,2558700,51,22,29
55,21,385,2558800,534,243,291
56,21,385,2558900,237,127,110
57,21,385,2559000,427,230,197
58,21,385,2559100,30,13,17
59,21,385,2559200,46,21,25
60,21,385,2559300,214,111,103
61,21,385,2559400,226,120,106
62,21,385,2559500,179,96,83
63,21,385,2559600,39,19,20
64,21,385,2559700,9,5,4
65,21,385,2559800,0,0,0
66,21,385,2559900,105,52,53
67,21,385,2560000,411,202,209
68,21,385,2560100,121,59,62
69,21,385,2560200,0,0,0
70,21,385,2560300,71,39,32
71,21,385,2560400,258,137,121
72,21,385,2560500,151,81,70
73,21,385,2560600,191,104,87
74,21,385,2560700,240,123,117
75,21,385,2560800,58,26,32
76,21,385,2560900,113,58,55
77,21,385,2561000,125,63,62
78,21,385,2561100,177,97,80
79,21,385,2561200,222,108,114
80,21,385,2561300,0,0,0
81,21,385,2561400,51,28,23
82,21,385,2561500,91,42,49
83,21,385,2561600,0,0,0
84,21,385,2561700,0,0,0
85,21,385,2561800,352,193,159
86,21,385,2561900,0,0,0
87,21,385,2562000,223,110,113
88,21,385,2562100,0,0,0
89,21,385,2562200,0,0,0
90,21,385,2562300,0,0,0
91,21,385,2562400,424,222,202
92,21,385,2562500,466,242,224
93,21,385,2562600,468,259,209
94,21,385,2562700,0,0,0
95,21,385,2562800,0,0,0
96,21,385,2562900,96,52,44
97,21,385,2563000,0,0,0
98,21,385,2563100,78,42,36
99,21,385,2563200,137,70,67
100,21,385,2563300,115,51,64
101,21,385,2563400,59,29,30
102,21,385,2563500,128,61,67
103,21,385,2563600,764,390,374
104,21,385,2563700,374,208,166
105,21,385,2563800,47,25,22
106,21,385,2563900,5238,2735,2503
107,21,385,2564000,481,237,244
108,21,385,2564100,355,176,179
109,21,385,2564200,130,67,63
110,21,385,2564300,574,288,286
111,21,385,2564400,259,120,139
112,21,385,2564500,187,94,93
113,21,385,2564600,43,23,20
114,21,385,2564700,375,186,189
115,21,385,2564800,110,64,46
116,21,385,2564900,678,340,338
117,21,385,2565000,0,0,0
118,21,385,2565100,136,73,63
119,21,385,2565200,45,18,27
120,21,385,2565300,53,21,32
121,21,385,2565400,0,0,0
122,21,385,2565500,41,19,22
123,21,385,2565600,70,30,40
124,21,385,2565700,0,0,0
125,21,385,2565800,38,16,22
126,21,385,2565900,57,31,26
127,21,385,2566000,0,0,0
128,21,385,2566100,89,46,43
129,21,385,2566200,11,7,4
130,21,385,2566300,76,31,45
131,21,385,2566400,9,4,5
132,21,385,2566500,71,38,33
133,21,385,2566600,53,28,25
134,21,385,2566700,0,0,0
135,21,385,2566800,0,0,0
136,21,385,2566900,116,50,66
137,21,385,2567000,37,19,18
138,21,385,2567100,80,47,33
139,21,385,2567200,0,0,0
140,21,385,2567300,49,21,28
141,21,385,2567400,8,3,5
142,21,385,2567500,0,0,0
143,21,385,2567600,27,14,13
144,21,385,2567700,226,113,113
145,21,385,2567800,6,3,3
146,21,385,2567900,133,69,64
147,21,385,2568000,95,48,47
148,21,385,2568100,76,35,41
149,21,385,2568200,631,312,319
150,21,385,2568300,156,76,80
151,21,385,2568400,6,2,4
152,21,385,2568500,16,9,7
153,21,385,2568600,30,14,16
154,21,385,2568700,48,22,26
155,21,385,2568800,53,28,25
156,21,385,2568900,0,0,0
157,21,385,2569000,4,2,2
158,21,385,2569100,72,33,39
159,21,385,2569200,161,81,80
160,21,385,2569300,8,5,3
161,21,385,2569400,63,29,34
162,21,385,2569500,47,23,24
163,21,385,2569600,74,36,38
164,21,385,2569700,336,171,165
165,21,385,2569800,6,4,2
166,21,385,2569900,21,10,11
167,21,385,2570000,16,8,8
168,21,385,2570100,27,14,13
169,21,385,2570200,12,7,5
170,21,385,2570300,0,0,0
171,21,385,2570400,31,12,19
172,21,385,2570500,116,65,51
173,21,385,2570600,59,34,25
174,21,385,2570700,17,9,8
175,21,385,2570800,27,13,14
176,21,385,2570900,152,82,70
177,21,385,2571000,7,2,5
178,21,385,2571100,161,76,85
179,21,385,2571200,196,96,100
180,21,385,2571300,0,0,0
181,21,385,2571400,0,0,0
182,21,385,2571500,316,159,157
183,21,385,2571600,87,43,44
184,21,385,2571700,0,0,0
185,21,385,2571800,0,0,0
186,21,385,2571900,303,144,159
187,21,385,2572000,15,7,8
188,21,385,2572100,0,0,0
189,21,385,2572200,161,75,86
190,21,385,2572300,0,0,0
191,21,385,2572400,105,49,56
192,21,385,2572500,159,75,84
193,21,385,2572600,197,102,95
194,21,385,2572700,0,0,0
195,21,385,2572800,0,0,0
196,21,385,2572900,291,132,159
197,21,385,2573000,140,78,62
198,21,385,2573100,51,23,28
199,21,385,2573200,70,35,35
200,21,385,2573300,250,126,124
201,21,385,2573400,384,199,185
202,21,385,2573500,115,57,58
203,21,385,2573600,227,105,122
204,21,385,2573700,208,100,108
205,21,385,2573800,38,21,17
206,21,385,2573900,175,93,82
207,21,385,2574000,159,80,79
208,21,385,2574100,101,48,53
209,21,385,2574200,142,67,75
210,21,385,2574300,68,29,39
211,21,385,2574400,0,0,0
212,21,385,2574500,40,17,23
213,21,385,2574600,0,0,0
214,21,385,2574700,13,7,6
215,21,385,2574800,32,15,17
216,21,385,2574900,125,67,58
217,21,385,2575000,0,0,0
218,21,385,2575100,401,200,201
219,21,385,2575200,56,29,27
220,21,385,2575300,38,17,21
221,21,385,2575400,43,19,24
222,21,385,2575500,519,271,248
223,21,385,2575600,0,0,0
224,21,385,2575700,553,307,246
225,21,385,2575800,404,205,199
226,21,385,2575900,838,429,409
227,21,385,2576000,733,364,369
228,21,385,2576100,2035,1034,1001
229,21,385,2576200,33,19,14
230,21,385,2576300,0,0,0
231,21,385,2576400,132,69,63
232,21,385,2576500,784,404,380
233,21,385,2576600,423,215,208
234,21,385,2576700,378,195,183
235,21,385,2576800,289,158,131
236,21,385,2576900,439,239,200
237,21,385,2577000,1075,546,529
238,21,385,2577100,536,277,259
239,21,385,2577200,0,0,0
240,21,385,2577300,962,509,453
241,21,385,2577400,3851,2024,1827
242,21,385,2577500,226,121,105
243,21,385,2577600,326,174,152
244,21,385,2577700,277,149,128
245,21,385,2577800,1089,558,531
246,21,385,2577900,797,416,381
247,21,385,2578000,240,126,114
248,21,385,2578100,147,80,67
249,21,385,2578200,742,356,386
250,21,385,2578300,163,79,84
251,21,385,2578400,1160,597,563
252,21,385,2578500,872,436,436
253,21,385,2578600,912,467,445
254,21,385,2578700,691,351,340
255,21,385,2578800,323,163,160
256,21,385,2578900,312,154,158
257,21,385,2579000,39,19,20
258,21,385,2579100,493,260,233
259,21,385,2579200,528,284,244
260,21,385,2579300,229,109,120
261,21,385,2579400,175,92,83
262,21,385,2579500,1388,717,671
263,21,385,2579600,0,0,0
264,21,385,2579700,1145,583,562
265,21,385,2579800,1560,829,731
266,21,385,2579900,1126,597,529
267,21,385,2580000,419,229,190
268,21,385,2580100,301,153,148
269,21,385,2580200,100,53,47
270,21,385,2580300,53,28,25
271,21,385,2580400,32,19,13
272,21,385,2580500,77,38,39
273,21,385,2580600,84,34,50
274,21,385,2580700,0,0,0
275,21,385,2580800,93,45,48
276,21,385,2580900,49,24,25
277,21,385,2581000,175,97,78
278,21,385,2581100,76,39,37
279,21,385,2581200,226,115,111
280,21,385,2581300,0,0,0
281,21,385,2581400,471,244,227
282,21,385,2581500,128,67,61
283,21,385,2581600,510,279,231
284,21,385,2581700,721,380,341
285,21,385,2581800,90,35,55
286,21,385,2581900,99,48,51
287,21,385,2582000,32,18,14
288,21,385,2582100,0,0,0
289,21,385,2582200,145,67,78
290,21,385,2582300,126,63,63
291,21,385,2582400,170,87,83
292,21,385,2582500,0,0,0
293,21,385,2582600,129,58,71
294,21,385,2582700,68,34,34
295,21,385,2582800,0,0,0
296,21,385,2582900,0,0,0
297,21,385,2583000,52,25,27
298,21,385,2583100,38,19,19
299,21,385,2583200,14,7,7
300,21,385,2583300,0,0,0
301,21,385,2583400,12,7,5
302,21,385,2583500,3,1,2
303,21,385,2583600,83,44,39
304,21,385,2583700,0,0,0
305,21,385,2583800,86,37,49
306,21,385,2583900,28,11,17
307,21,385,2584000,0,0,0
308,21,385,2584100,32,12,20
309,21,385,2584200,269,134,135
310,21,385,2584300,81,44,37
311,21,385,2584400,24,10,14
312,21,385,2584500,53,26,27
313,21,385,2584600,25,14,11
314,21,385,2584700,0,0,0
315,21,385,2584800,0,0,0
316,21,385,2584900,26,13,13
317,21,385,2585000,152,74,78
318,21,385,2585100,182,96,86
319,21,385,2585200,138,77,61
320,21,385,2585300,253,123,130
321,21,385,2585400,29,15,14
322,21,385,2585500,145,70,75
323,21,385,2585600,75,38,37
324,21,385,2585700,28,12,16
325,21,385,2585800,40,20,20
326,21,385,2585900,50,28,22
327,21,385,2586000,0,0,0
328,21,385,2586100,52,27,25
329,21,385,2586200,0,0,0
330,21,385,2586300,25,15,10
331,21,385,2586400,39,18,21
332,21,385,2586500,35,19,16
333,21,385,2586600,152,76,76
334,21,385,2586700,1381,693,688
335,21,385,2586800,79,40,39
336,21,385,2586900,163,80,83
337,21,385,2587000,131,64,67
338,21,385,2587100,122,54,68
339,21,385,2587200,76,39,37
340,21,385,2587300,40,19,21
341,21,385,2587400,21,11,10
342,21,385,2587500,521,241,280
343,21,385,2587600,176,94,82
344,21,385,2587700,31,15,16
345,21,385,2587800,187,93,94
346,21,385,2587900,158,83,75
347,21,385,2588000,311,156,155
348,21,385,2588100,39,20,19
349,21,385,2588200,132,72,60
350,21,385,2588300,4,0,4
351,21,385,2588400,30,15,15
352,21,385,2588500,57,30,27
353,21,385,2588600,32,16,16
354,21,385,2588700,287,156,131
355,21,385,2588800,79,41,38
356,21,385,2588900,605,310,295
357,21,385,2589000,111,60,51
358,21,385,2589100,35,18,17
359,21,385,2589200,58,31,27
360,21,385,2589300,734,357,377
361,21,385,2589400,230,105,125
362,21,385,2589500,169,83,86
363,21,385,2589600,100,53,47
364,21,385,2589700,67,37,30
365,21,385,2589800,0,0,0
366,21,385,2589900,37,21,16
367,21,385,2590000,28,13,15
368,21,385,2590100,45,19,26
369,21,385,2590200,32,17,15
370,21,385,2590300,676,335,341
371,21,385,2590400,736,366,370
372,21,385,2590500,551,282,269
373,21,385,2590600,611,317,294
374,21,385,2590700,152,81,71
375,21,385,2590800,0,0,0
376,21,385,2590900,0,0,0
377,21,385,2591000,0,0,0
378,21,385,2591100,117,57,60
379,21,385,2591200,122,59,63
380,21,385,2591300,327,179,148
381,21,385,2591400,598,321,277
382,21,385,2591500,195,97,98
383,21,385,2591600,296,159,137
384,21,385,2591700,416,203,213
385,21,385,2591800,929,481,448
386,21,385,2591900,34,17,17
387,21,385,2592000,15,8,7
388,21,385,2592100,184,95,89
389,21,385,2592200,153,74,79
390,21,385,2592300,9,5,4
391,21,385,2592400,29,15,14
392,21,385,2592500,86,39,47
393,21,385,2592600,28,14,14
394,21,385,2592700,67,33,34
395,21,385,2592800,182,88,94
396,21,385,2592900,136,67,69
397,21,385,2593000,230,116,114
398,21,385,2593100,87,46,41
399,21,385,2593200,153,75,78
400,21,385,2593300,138,68,70
401,21,385,2593400,49,25,24
402,21,385,2593500,0,0,0
403,21,385,2593600,66,34,32
404,21,385,2593700,70,28,42
405,21,385,2593800,0,0,0
406,21,385,2593900,101,57,44
407,21,385,2594000,19,9,10
408,21,385,2594100,25,10,15
409,21,385,2594200,163,86,77
410,21,385,2594300,187,96,91
411,21,385,2594400,427,223,204
412,21,385,2594500,141,68,73
413,21,385,2594600,298,164,134
414,21,385,2594700,27,15,12
415,21,385,2594800,108,51,57
416,21,385,2594900,0,0,0
417,21,385,2595000,80,41,39
418,21,385,2595100,0,0,0
419,21,385,2595200,164,79,85
420,21,385,2595300,0,0,0
421,21,385,2595400,80,48,32
422,21,385,2595500,51,23,28
423,21,385,2595600,0,0,0
424,21,385,2595700,167,89,78
425,21,385,2595800,0,0,0
426,21,385,2595900,67,31,36
427,21,385,2596000,82,38,44
428,21,385,2596100,55,21,34
429,21,385,2596200,30,15,15
430,21,385,2596300,20,10,10
431,21,385,2596400,85,39,46
432,21,385,2596500,99,50,49
433,21,385,2596600,18,7,11
434,21,385,2596700,199,96,103
435,21,385,2596800,216,105,111
436,21,385,2596900,21,10,11
437,21,385,2597000,31,14,17
438,21,385,2597100,75,37,38
439,21,385,2597200,22,11,11
440,21,385,2597300,58,32,26
441,21,385,2597400,24,13,11
442,21,385,2597500,67,37,30
443,21,385,2597600,25,12,13
444,21,385,2597700,160,76,84
445,21,385,2597800,435,269,166
446,21,385,2597900,221,118,103
447,21,385,2598000,36,17,19
448,21,385,2598100,27,14,13
449,21,385,2598200,7,3,4
450,21,385,2598300,120,58,62
451,21,385,2598400,10,6,4
452,21,385,2598500,0,0,0
453,21,385,2598600,38,17,21
454,21,385,2598700,56,31,25
455,21,385,2598800,22,11,11
456,21,385,2598900,37,19,18
457,21,385,2599000,227,123,104
458,21,385,2599100,48,25,23
459,21,385,2599200,132,68,64
460,21,385,2599300,78,44,34
461,21,385,2599400,62,32,30
462,21,385,2599500,779,402,377
463,21,385,2599600,654,331,323
464,21,385,2599700,92,43,49
465,21,385,2599800,39,20,19
466,21,385,2599900,0,0,0
467,21,385,2600000,83,43,40
468,21,385,2600100,434,212,222
469,21,385,2600200,352,186,166
470,21,385,2600300,185,99,86
471,21,385,2600400,194,103,91
472,21,385,2600500,22,15,7
473,21,385,2600600,426,227,199
474,21,385,2600700,146,71,75
475,21,385,2600800,469,258,211
476,21,385,2600900,34,16,18
477,21,385,2601000,693,375,318
478,21,385,2601100,286,144,142
479,21,385,2601200,0,0,0
480,21,385,2601300,0,0,0
481,21,385,2601400,654,340,314
482,21,385,2601500,1039,541,498
483,21,385,2601600,617,330,287
484,21,385,2601700,429,220,209
485,21,385,2601800,0,0,0
486,21,385,2601900,829,416,413
487,21,385,2602000,764,377,387
488,21,385,2602100,469,246,223
489,21,385,2602200,498,269,229
490,21,385,2602300,0,0,0
491,21,385,2602400,155,70,85
492,21,385,2602500,83,41,42
493,21,385,2602600,1434,747,687
494,21,385,2602700,1100,586,514
495,21,385,2602800,0,0,0
496,21,385,2602900,299,150,149
497,21,385,2603000,95,54,41
498,21,385,2603100,552,288,264
499,21,385,2603200,266,141,125
500,21,385,2603300,1720,906,814
501,21,385,2603400,487,262,225
502,21,385,2603500,572,314,258
503,21,385,2603600,28,16,12
504,21,385,2603700,96,47,49
505,21,385,2603800,318,162,156
506,21,385,2603900,162,78,84
507,21,385,2604000,260,122,138
508,21,385,2604100,232,119,113
509,21,385,2604200,163,82,81
510,21,385,2604300,237,118,119
511,21,385,2604400,317,155,162
512,21,385,2604500,397,215,182
513,21,385,2604600,0,0,0
514,21,385,2604700,240,128,112
515,21,385,2604800,91,41,50
516,21,385,2604900,804,412,392
517,21,385,2605000,1948,1007,941
518,21,385,2605100,327,174,153
519,21,385,2605200,769,384,385
520,21,385,2605300,0,0,0
521,21,385,2605400,0,0,0
522,21,385,2605500,0,0,0
523,21,385,2605600,559,288,271
524,21,385,2605700,1865,1010,855
525,21,385,2605800,565,282,283
526,21,385,2605900,151,79,72
527,21,385,2606000,443,240,203
528,21,385,2606100,685,353,332
529,21,385,2606200,277,142,135
530,21,385,2606300,2562,1336,1226
531,21,385,2606400,279,151,128
532,21,385,2606500,1291,683,608
533,21,385,2606600,120,60,60
534,21,385,2606700,365,196,169
535,21,385,2606800,0,0,0
536,21,385,2606900,0,0,0
537,21,385,2607000,36,19,17
538,21,385,2607100,0,0,0
539,21,385,2607200,182,84,98
540,21,385,2607300,76,36,40
541,21,385,2607400,930,458,472
542,21,385,2607500,173,86,87
543,21,385,2607600,172,95,77
544,21,385,2607700,2108,1116,992
545,21,385,2607800,23,13,10
546,21,385,2607900,0,0,0
547,21,385,2608000,0,0,0
548,21,385,2608100,300,153,147
549,21,385,2608200,0,0,0
550,21,385,2608300,163,84,79
551,21,385,2608400,217,111,106
552,21,385,2608500,442,240,202
553,21,385,2608600,0,0,0
554,21,385,2608700,0,0,0
555,21,385,2608800,0,0,0
556,21,385,2608900,29,13,16
557,21,385,2609000,0,0,0
558,21,385,2609100,475,260,215
559,21,385,2609200,254,131,123
560,21,385,2609300,85,47,38
561,21,385,2609400,760,390,370
562,21,385,2609500,0,0,0
563,21,385,2609600,875,466,409
564,21,385,2609700,426,221,205
565,21,385,2609800,908,478,430
566,21,385,2609900,755,369,386
567,21,385,2610000,339,179,160
568,21,385,2610100,267,137,130
569,21,385,2610200,433,228,205
570,21,385,2610300,160,79,81
571,21,385,2610400,371,180,191
572,21,385,2610500,57,23,34
573,21,385,2610600,208,108,100
574,21,385,2610700,447,238,209
575,21,385,2610800,417,216,201
576,21,385,2610900,26,12,14
577,21,385,2611000,1409,745,664
578,21,385,2611100,335,181,154
579,21,385,2611200,396,196,200
580,21,385,2611300,329,158,171
581,21,385,2611400,1889,1000,889
582,21,385,2611500,458,238,220
583,21,385,2611600,76,39,37
584,21,385,2611700,517,254,263
585,21,385,2611800,325,169,156
586,21,385,2611900,472,255,217
587,21,385,2612000,537,291,246
588,21,385,2612100,545,265,280
589,21,385,2612200,625,316,309
590,21,385,2612300,79,39,40
591,21,385,2612400,192,103,89
592,21,385,2612500,131,57,74
593,21,385,2612600,71,33,38
594,21,385,2612700,62,32,30
595,21,385,2612800,0,0,0
596,21,385,2612900,72,39,33
597,21,385,2613000,57,31,26
598,21,385,2613100,43,21,22
599,21,385,2613200,70,34,36
600,21,385,2613300,405,214,191
601,21,385,2613400,383,192,191
602,21,385,2613500,66,35,31
603,21,385,2613600,83,39,44
604,21,385,2613700,272,135,137
605,21,385,2613800,541,265,276
606,21,385,2613900,6,2,4
607,21,385,2614000,79,41,38
608,21,385,2614100,40,18,22
609,21,385,2614200,31,18,13
610,21,385,2614300,87,46,41
611,21,385,2614400,373,197,176
612,21,385,2614500,284,148,136
613,21,385,2614600,41,23,18
614,21,385,2614700,70,33,37
615,21,385,2614800,20,11,9
616,21,385,2614900,422,221,201
617,21,385,2615000,777,432,345
618,21,385,2615100,623,342,281
619,21,385,2615200,83,42,41
620,21,385,2615300,79,39,40
621,21,385,2615400,28,12,16
622,21,385,2615500,49,22,27
623,21,385,2615600,11,4,7
624,21,385,2615700,71,31,40
625,21,385,2615800,3,1,2
626,21,385,2615900,320,153,167
627,21,385,2616000,33,18,15
628,21,385,2616100,20,8,12
629,21,385,2616200,53,27,26
630,21,385,2616300,22,10,12
631,21,385,2616400,360,246,114
632,21,385,2616500,356,182,174
633,21,385,2616600,280,145,135
634,21,385,2616700,0,0,0
635,21,385,2616800,67,32,35
636,21,385,2616900,38,20,18
637,21,385,2617000,510,259,251
638,21,385,2617100,304,148,156
639,21,385,2617200,361,182,179
640,21,385,2617300,511,279,232
641,21,385,2617400,1213,644,569
642,21,385,2617500,1151,606,545
643,21,385,2617600,360,189,171
644,21,385,2617700,1654,898,756
645,21,385,2617800,0,0,0
646,21,385,2617900,0,0,0
647,21,385,2618000,651,349,302
648,21,385,2618100,86,45,41
649,21,385,2618200,1260,637,623
650,21,385,2618300,546,281,265
651,21,385,2618400,1183,625,558
652,21,385,2618500,86,48,38
653,21,385,2618600,407,227,180
654,21,385,2618700,709,368,341
655,21,385,2618800,365,191,174
656,21,385,2618900,1443,779,664
657,21,385,2619000,822,444,378
658,21,385,2619100,1127,589,538
659,21,385,2619200,528,275,253
660,21,385,2619300,3143,1622,1521
661,21,385,2619400,89,47,42
662,21,385,2619500,76,40,36
663,21,385,2619600,492,258,234
664,21,385,2619700,249,122,127
665,21,385,2619800,0,0,0
666,21,385,2619900,397,196,201
667,21,385,2620000,203,107,96
668,21,385,2620100,622,310,312
669,21,385,2620200,46,25,21
670,21,385,2620300,21,9,12
671,21,385,2620400,56,26,30
672,21,385,2620500,1547,809,738
673,21,385,2620600,89,52,37
674,21,385,2620700,11,7,4
675,21,385,2620800,72,33,39
676,21,385,2620900,0,0,0
677,21,385,2621000,192,100,92
678,21,385,2621100,259,138,121
679,21,385,2621200,101,57,44
680,21,385,2621300,0,0,0
681,21,385,2621400,299,153,146
682,21,385,2621500,15,9,6
683,21,385,2621600,2155,1097,1058
684,21,385,2621700,885,452,433
685,21,385,2621800,173,84,89
686,21,385,2621900,741,394,347
687,21,385,2622000,1939,1034,905
688,21,385,2622100,0,0,0
689,21,385,2622200,629,332,297
690,21,385,2622300,356,173,183
691,21,385,2622400,57,27,30
692,21,385,2622500,134,67,67
693,21,385,2622600,2868,1499,1369
694,21,385,2622700,1262,662,600
695,21,385,2622800,165,85,80
696,21,385,2622900,568,309,259
697,21,385,2623000,654,339,315
698,21,385,2623100,1073,570,503
699,21,385,2623200,268,140,128
700,21,385,2623300,938,477,461
701,21,385,2623400,1081,562,519
702,21,385,2623500,687,355,332
703,21,385,2623600,393,202,191
704,21,385,2623700,1039,509,530
705,21,385,2623800,2338,1191,1147
706,21,385,2623900,0,0,0
707,21,385,2624000,512,292,220
708,21,385,2624100,375,192,183
709,21,385,2624200,307,144,163
710,21,385,2624300,343,162,181
711,21,385,2624400,524,265,259
712,21,385,2624500,2364,1213,1151
713,21,385,2624600,7,4,3
714,21,385,2624700,923,494,429
715,21,385,2624800,654,327,327
716,21,385,2624900,996,481,515
717,21,385,2625000,1732,881,851
718,21,385,2625100,1723,871,852
719,21,385,2625200,0,0,0
720,21,385,2625300,313,165,148
721,21,385,2625400,495,249,246
722,21,385,2625500,1599,811,788
723,21,385,2625600,1322,708,614
724,21,385,2625700,535,281,254
725,21,385,2625800,408,199,209
726,21,385,2625900,531,265,266
727,21,385,2626000,43,19,24
728,21,385,2626100,2007,1020,987
729,21,385,2626200,175,96,79
730,21,385,2626300,211,115,96
731,21,385,2626400,2384,1228,1156
732,21,385,2626500,940,470,470
733,21,385,2626600,692,365,327
734,21,385,2626700,2698,1374,1324
735,21,385,2626800,711,369,342
736,21,385,2626900,327,166,161
737,21,385,2627000,302,150,152
738,21,385,2627100,1434,737,697
739,21,385,2627200,3869,1985,1884
740,21,385,2627300,196,102,94
741,21,385,2627400,721,358,363
742,21,385,2627500,2440,1243,1197
743,21,385,2627600,586,285,301
744,21,385,2627700,167,88,79
745,21,385,2627800,283,144,139
746,21,385,2627900,195,98,97
747,21,385,2628000,146,71,75
748,21,385,2628100,567,294,273
749,21,385,2628200,0,0,0
750,21,385,2628300,10,5,5
751,21,385,2628400,903,471,432
752,21,385,2628500,360,190,170
753,21,385,2628600,769,404,365
754,21,385,2628700,742,391,351
755,21,385,2628800,0,0,0
756,21,385,2628900,142,67,75
757,21,385,2629000,1166,593,573
758,21,385,2629100,2058,1093,965
759,21,385,2629200,0,0,0
760,21,385,2629300,153,81,72
761,21,385,2629400,230,117,113
762,21,385,2629500,203,105,98
763,21,385,2629600,570,289,281
764,21,385,2629700,0,0,0
765,21,385,2629800,358,190,168
766,21,385,2629900,252,127,125
767,21,385,2630000,1389,728,661
768,21,385,2630100,0,0,0
769,21,385,2630200,468,242,226
770,21,385,2630300,801,422,379
771,21,385,2630400,1674,887,787
772,21,385,2630500,613,298,315
773,21,385,2630600,0,0,0
774,21,385,2630700,969,503,466
775,21,385,2630800,419,218,201
776,21,385,2630900,868,430,438
777,21,385,2631000,495,254,241
778,21,385,2631100,430,214,216
779,21,385,2631200,53,22,31
780,21,385,2631300,387,198,189
781,21,385,2631400,404,212,192
782,21,385,2631500,43,21,22
783,21,385,2631600,214,111,103
784,21,385,2631700,1385,722,663
785,21,385,2631800,464,252,212
786,21,385,2631900,625,318,307
787,21,385,2632000,746,381,365
788,21,385,2632100,1040,526,514
789,21,385,2632200,299,153,146
790,21,385,2632300,884,453,431
791,21,385,2632400,247,125,122
792,21,385,2632500,477,232,245
793,21,385,2632600,563,288,275
794,21,385,2632700,647,343,304
795,21,385,2632800,256,120,136
796,21,385,2632900,636,315,321
797,21,385,2633000,2282,1093,1189
798,21,385,2633100,1262,625,637
799,21,385,2633200,568,296,272
800,21,385,2633300,648,328,320
801,21,385,2633400,242,119,123
802,21,385,2633500,561,273,288
803,21,385,2633600,582,298,284
804,21,385,2633700,281,136,145
805,21,385,2633800,307,153,154
806,21,385,2633900,1428,724,704
807,21,385,2634000,3609,1829,1780
808,21,385,2634100,68,37,31
809,21,385,2634200,1197,619,578
810,21,385,2634300,387,194,193
811,21,385,2634400,0,0,0
812,21,385,2634500,625,329,296
813,21,385,2634600,471,246,225
814,21,385,2634700,389,197,192
815,21,385,2634800,0,0,0
816,21,385,2634900,394,194,200
817,21,385,2635000,206,106,100
818,21,385,2635100,1032,538,494
819,21,385,2635200,0,0,0
820,21,385,2635300,481,250,231
821,21,385,2635400,550,286,264
822,21,385,2635500,1086,575,511
823,21,385,2635600,0,0,0
824,21,385,2635700,464,236,228
825,21,385,2635800,630,311,319
826,21,385,2635900,723,367,356
827,21,385,2636000,402,205,197
828,21,385,2636100,413,213,200
829,21,385,2636200,887,455,432
830,21,385,2636300,298,153,145
831,21,385,2636400,984,500,484
832,21,385,2636500,347,176,171
833,21,385,2636600,0,0,0
834,21,385,2636700,230,119,111
835,21,385,2636800,797,413,384
836,21,385,2636900,0,0,0
837,21,385,2637000,321,169,152
838,21,385,2637100,549,282,267
839,21,385,2637200,0,0,0
840,21,385,2637300,133,73,60
841,21,385,2637400,1351,680,671
842,21,385,2637500,1505,782,723
843,21,385,2637600,843,418,425
844,21,385,2637700,27,12,15
845,21,385,2637800,307,165,142
846,21,385,2637900,127,67,60
847,21,385,2638000,93,48,45
848,21,385,2638100,0,0,0
849,21,385,2638200,1191,636,555
850,21,385,2638300,0,0,0
851,21,385,2638400,67,37,30
852,21,385,2638500,464,237,227
853,21,385,2638600,0,0,0
854,21,385,2638700,65,31,34
855,21,385,2638800,58,32,26
856,21,385,2638900,130,71,59
857,21,385,2639000,21,11,10
858,21,385,2639100,88,47,41
859,21,385,2639200,94,53,41
860,21,385,2639300,865,461,404
861,21,385,2639400,119,58,61
862,21,385,2639500,153,84,69
863,21,385,2639600,346,178,168
864,21,385,2639700,0,0,0
865,21,385,2639800,120,63,57
866,21,385,2639900,783,402,381
867,21,385,2640000,93,52,41
868,21,385,2640100,2852,1479,1373
869,21,385,2640200,981,522,459
870,21,385,2640300,389,186,203
871,21,385,2640400,2508,1311,1197
872,21,385,2640500,876,469,407
873,21,385,2640600,678,346,332
874,21,385,2640700,667,341,326
875,21,385,2640800,292,153,139
876,21,385,2640900,201,100,101
877,21,385,2641000,0,0,0
878,21,385,2641100,500,279,221
879,21,385,2641200,313,172,141
880,21,385,2641300,384,203,181
881,21,385,2641400,659,343,316
882,21,385,2641500,1549,834,715
883,21,385,2641600,958,501,457
884,21,385,2641700,516,274,242
885,21,385,2641800,478,255,223
886,21,385,2641900,236,126,110
887,21,385,2642000,503,259,244
888,21,385,2642100,259,137,122
889,21,385,2642200,1647,883,764
890,21,385,2642300,1184,608,576
891,21,385,2642400,814,431,383
892,21,385,2642500,0,0,0
893,21,385,2642600,396,216,180
894,21,385,2642700,184,100,84
895,21,385,2642800,180,90,90
896,21,385,2642900,837,423,414
897,21,385,2643000,0,0,0
898,21,385,2643100,1140,589,551
899,21,385,2643200,837,442,395
900,21,385,2643300,808,406,402
901,21,385,2643400,275,133,142
902,21,385,2643500,79,40,39
903,21,385,2643600,421,235,186
904,21,385,2643700,368,200,168
905,21,385,2643800,129,63,66
906,21,385,2643900,329,174,155
907,21,385,2644000,601,322,279
908,21,385,2644100,400,204,196
909,21,385,2644200,671,360,311
910,21,385,2644300,821,429,392
911,21,385,2644400,516,272,244
912,21,385,2644500,156,83,73
913,21,385,2644600,560,296,264
914,21,385,2644700,601,307,294
915,21,385,2644800,402,210,192
916,21,385,2644900,39,19,20
917,21,385,2645000,271,141,130
918,21,385,2645100,715,375,340
919,21,385,2645200,655,341,314
920,21,385,2645300,512,269,243
921,21,385,2645400,120,62,58
922,21,385,2645500,195,113,82
923,21,385,2645600,988,498,490
924,21,385,2645700,464,251,213
925,21,385,2645800,702,374,328
926,21,385,2645900,1108,579,529
927,21,385,2646000,580,288,292
928,21,385,2646100,44,19,25
929,21,385,2646200,1192,626,566
930,21,385,2646300,663,357,306
931,21,385,2646400,556,294,262
932,21,385,2646500,854,449,405
933,21,385,2646600,619,316,303
934,21,385,2646700,443,222,221
935,21,385,2646800,3489,1782,1707
936,21,385,2646900,1464,779,685
937,21,385,2647000,404,202,202
938,21,385,2647100,913,467,446
939,21,385,2647200,762,402,360
940,21,385,2647300,568,308,260
941,21,385,2647400,1270,694,576
942,21,385,2647500,3233,1689,1544
943,21,385,2647600,1571,826,745
944,21,385,2647700,1278,647,631
945,21,385,2647800,347,177,170
946,21,385,2647900,239,126,113
947,21,385,2648000,3322,1740,1582
948,21,385,2648100,510,268,242
949,21,385,2648200,551,265,286
950,21,385,2648300,0,0,0
951,21,385,2648400,144,78,66
952,21,385,2648500,245,124,121
953,21,385,2648600,192,97,95
954,21,385,2648700,497,258,239
955,21,385,2648800,19,8,11
956,21,385,2648900,788,419,369
957,21,385,2649000,592,317,275
958,21,385,2649100,3595,1874,1721
959,21,385,2649200,731,375,356
960,21,385,2649300,341,187,154
961,21,385,2649400,778,425,353
962,21,385,2649500,8122,4237,3885
963,21,385,2649600,1058,534,524
964,21,385,2649700,456,225,231
965,21,385,2649800,596,317,279
966,21,385,2649900,572,288,284
967,21,385,2650000,514,268,246
968,21,385,2650100,790,402,388
969,21,385,2650200,1195,627,568
970,21,385,2650300,1040,560,480
971,21,385,2650400,4771,2510,2261
972,21,385,2650500,188,93,95
973,21,385,2650600,907,467,440
974,21,385,2650700,2265,1202,1063
975,21,385,2650800,700,353,347
976,21,385,2650900,1893,975,918
977,21,385,2651000,630,307,323
978,21,385,2651100,1219,647,572
979,21,385,2651200,452,248,204
980,21,385,2651300,253,130,123
981,21,385,2651400,965,492,473
982,21,385,2651500,1443,748,695
983,21,385,2651600,245,129,116
984,21,385,2651700,0,0,0
985,21,385,2651800,171,87,84
986,21,385,2651900,26,11,15
987,21,385,2652000,4,1,3
988,21,385,2652100,423,223,200
989,21,385,2652200,112,57,55
990,21,385,2652300,430,221,209
991,21,385,2652400,875,438,437
992,21,385,2652500,48,28,20
993,21,385,2652600,161,83,78
994,21,385,2652700,490,248,242
995,21,385,2652800,404,211,193
996,21,385,2652900,2146,1093,1053
997,21,385,2653000,410,211,199
998,21,385,2653100,413,217,196
999,21,385,2653200,1826,982,844
1000,21,385,2653300,638,337,301
1001,21,385,2653400,517,280,237
1002,21,385,2653500,567,316,251
1003,21,385,2653600,146,77,69
1004,21,385,2653700,732,361,371
1005,21,385,2653800,352,185,167
1006,21,385,2653900,1208,621,587
1007,21,385,2654000,654,343,311
1008,21,385,2654100,760,401,359
1009,21,385,2654200,1741,884,857
1010,21,385,2654300,1336,665,671
1011,21,385,2654400,433,235,198
1012,21,385,2654500,4961,2572,2389
1013,21,385,2654600,501,260,241
1014,21,385,2654700,597,313,284
1015,21,385,2654800,288,147,141
1016,21,385,2654900,1270,658,612
1017,21,385,2655000,83,45,38
1018,21,385,2655100,437,237,200
1019,21,385,2655200,918,465,453
1020,21,385,2655300,460,232,228
1021,21,385,2655400,386,202,184
1022,21,385,2655500,136,67,69
1023,21,385,2655600,0,0,0
1024,21,385,2655700,506,258,248
1025,21,385,2655800,76,34,42
1026,21,385,2655900,1323,664,659
1027,21,385,2656000,1338,698,640
1028,21,385,2656100,250,134,116
1029,21,385,2656200,198,93,105
1030,21,385,2656300,0,0,0
1031,21,385,2656400,818,411,407
1032,21,385,2656500,169,90,79
1033,21,385,2656600,30,14,16
1034,21,385,2656700,105,54,51
1035,21,385,2656800,763,399,364
1036,21,385,2656900,131,67,64
1037,21,385,2657000,109,51,58
1038,21,385,2657100,106,54,52
1039,21,385,2657200,247,127,120
1040,21,385,2657300,71,37,34
1041,21,385,2657400,146,76,70
1042,21,385,2657500,635,306,329
1043,21,385,2657600,183,94,89
1044,21,385,2657700,184,100,84
1045,21,385,2657800,167,78,89
1046,21,385,2657900,93,49,44
1047,21,385,2658000,767,382,385
1048,21,385,2658100,1186,620,566
1049,21,385,2658200,342,162,180
1050,21,385,2658300,1214,631,583
1051,21,385,2658400,185,105,80
1052,21,385,2658500,319,154,165
1053,21,385,2658600,66,38,28
1054,21,385,2658700,71,32,39
1055,21,385,2658800,61,27,34
1056,21,385,2658900,88,43,45
1057,21,385,2659000,1655,811,844
1058,21,385,2659100,10,7,3
1059,21,385,2659200,188,86,102
1060,21,385,2659300,1608,839,769
1061,21,385,2659400,55,31,24
1062,21,385,2659500,223,117,106
1063,21,385,2659600,224,116,108
1064,21,385,2659700,136,71,65
1065,21,385,2659800,1408,726,682
1066,21,385,2659900,190,93,97
1067,21,385,2660000,62,28,34
1068,21,385,2660100,110,52,58
1069,21,385,2660200,86,44,42
1070,21,385,2660300,125,57,68
1071,21,385,2660400,19,7,12
1072,21,385,2660500,139,68,71
1073,21,385,2660600,78,37,41
1074,21,385,2660700,76,36,40
1075,21,385,2660800,59,28,31
1076,21,385,2660900,71,37,34
1077,21,385,2661000,123,68,55
1078,21,385,2661100,38,17,21
1079,21,385,2661200,218,113,105
1080,21,385,2661300,0,0,0
1081,21,385,2661400,127,60,67
1082,21,385,2661500,49,28,21
1083,21,385,2661600,35,14,21
1084,21,385,2661700,107,57,50
1085,21,385,2661800,37,20,17
1086,21,385,2661900,58,35,23
1087,21,385,2662000,351,171,180
1088,21,385,2662100,301,153,148
1089,21,385,2662200,1200,617,583
1090,21,385,2662300,469,236,233
1091,21,385,2662400,186,93,93
1092,21,385,2662500,365,187,178
1093,21,385,2662600,219,112,107
1094,21,385,2662700,596,299,297
1095,21,385,2662800,0,0,0
1096,21,385,2662900,0,0,0
1097,21,385,2663000,0,0,0
1098,21,385,2663100,245,118,127
1099,21,385,2663200,0,0,0
1100,21,385,2663300,168,93,75
1101,21,385,2663400,371,190,181
1102,21,385,2663500,439,230,209
1103,21,385,2663600,328,173,155
1104,21,385,2663700,136,67,69
1105,21,385,2663800,157,77,80
1106,21,385,2663900,50,28,22
1107,21,385,2664000,92,45,47
1108,21,385,2664100,555,289,266
1109,21,385,2664200,636,327,309
1110,21,385,2664300,28,16,12
1111,21,385,2664400,510,274,236
1112,21,385,2664500,1064,587,477
1113,21,385,2664600,407,214,193
1114,21,385,2664700,596,332,264
1115,21,385,2664800,331,172,159
1116,21,385,2664900,826,435,391
1117,21,385,2665000,857,458,399
1118,21,385,2665100,531,279,252
1119,21,385,2665200,2608,1396,1212
1120,21,385,2665300,389,202,187
1121,21,385,2665400,683,358,325
1122,21,385,2665500,0,0,0
1123,21,385,2665600,399,199,200
1124,21,385,2665700,47,28,19
1125,21,385,2665800,385,209,176
1126,21,385,2665900,236,116,120
1127,21,385,2666000,13,6,7
1128,21,385,2666100,35,16,19
1129,21,385,2666200,125,61,64
1130,21,385,2666300,512,259,253
1131,21,385,2666400,126,57,69
1132,21,385,2666500,511,346,165
1133,21,385,2666600,125,56,69
1134,21,385,2666700,91,46,45
1135,21,385,2666800,75,40,35
1136,21,385,2666900,504,260,244
1137,21,385,2667000,173,88,85
1138,21,385,2667100,24,13,11
1139,21,385,2667200,79,37,42
1140,21,385,2667300,26,14,12
1141,21,385,2667400,114,53,61
1142,21,385,2667500,88,49,39
1143,21,385,2667600,40,19,21
1144,21,385,2667700,75,34,41
1145,21,385,2667800,97,50,47
1146,21,385,2667900,0,0,0
1147,21,385,2668000,240,130,110
1148,21,385,2668100,125,66,59
1149,21,385,2668200,0,0,0
1150,21,385,2668300,121,61,60
1151,21,385,2668400,40,19,21
1152,21,385,2668500,67,31,36
1153,21,385,2668600,45,28,17
1154,21,385,2668700,63,30,33
1155,21,385,2668800,38,21,17
1156,21,385,2668900,898,474,424
1157,21,385,2669000,89,42,47
1158,21,385,2669100,66,38,28
1159,21,385,2669200,48,27,21
1160,21,385,2669300,59,31,28
1161,21,385,2669400,78,39,39
1162,21,385,2669500,150,73,77
1163,21,385,2669600,102,58,44
1164,21,385,2669700,90,44,46
1165,21,385,2669800,846,436,410
1166,21,385,2669900,280,154,126
1167,21,385,2670000,0,0,0
1168,21,385,2670100,313,161,152
1169,21,385,2670200,144,80,64
1170,21,385,2670300,224,121,103
1171,21,385,2670400,0,0,0
1172,21,385,2670500,324,178,146
1173,21,385,2670600,921,478,443
1174,21,385,2670700,442,241,201
1175,21,385,2670800,471,232,239
1176,21,385,2670900,115,54,61
1177,21,385,2671000,126,57,69
1178,21,385,2671100,4498,2387,2111
1179,21,385,2671200,409,192,217
1180,21,385,2671300,145,67,78
1181,21,385,2671400,654,345,309
1182,21,385,2671500,31,17,14
1183,21,385,2671600,120,59,61
1184,21,385,2671700,0,0,0
1185,21,385,2671800,68,38,30
1186,21,385,2671900,19,9,10
1187,21,385,2672000,99,44,55
1188,21,385,2672100,49,27,22
1189,21,385,2672200,23,12,11
1190,21,385,2672300,82,39,43
1191,21,385,2672400,0,0,0
1192,21,385,2672500,90,40,50
1193,21,385,2672600,224,133,91
1194,21,385,2672700,289,140,149
1195,21,385,2672800,51,25,26
1196,21,385,2672900,11,5,6
1197,21,385,2673000,5,2,3
1198,21,385,2673100,1,1,0
1199,21,385,2673200,111,60,51
1200,21,385,2673300,21,13,8
1201,21,385,2673400,19,11,8
1202,21,385,2673500,70,40,30
1203,21,385,2673600,775,406,369
1204,21,385,2673700,417,211,206
1205,21,385,2673800,745,366,379
1206,21,385,2673900,481,272,209
1207,21,385,2674000,336,172,164
1208,21,385,2674100,62,30,32
1209,21,385,2674200,730,375,355
1210,21,385,2674300,263,131,132
1211,21,385,2674400,268,136,132
1212,21,385,2674500,158,84,74
1213,21,385,2674600,487,255,232
1214,21,385,2674700,1790,951,839
1215,21,385,2674800,19,9,10
1216,21,385,2674900,0,0,0
1217,21,385,2675000,123,67,56
1218,21,385,2675100,299,157,142
1219,21,385,2675200,337,163,174
1220,21,385,2675300,329,164,165
1221,21,385,2675400,86,46,40
1222,21,385,2675500,90,46,44
1223,21,385,2675600,60,31,29
1224,21,385,2675700,23,13,10
1225,21,385,2675800,320,163,157
1226,21,385,2675900,800,394,406
1227,21,385,2676000,138,69,69
1228,21,385,2676100,498,262,236
1229,21,385,2676200,599,297,302
1230,21,385,2676300,95,51,44
1231,21,385,2676400,452,230,222
1232,21,385,2676500,831,424,407
1233,21,385,2676600,202,96,106
1234,21,385,2676700,1077,551,526
1235,21,385,2676800,876,461,415
1236,21,385,2676900,66,36,30
1237,21,385,2677000,2059,1020,1039
1238,21,385,2677100,0,0,0
1239,21,385,2677200,444,236,208
1240,21,385,2677300,353,184,169
1241,21,385,2677400,162,88,74
1242,21,385,2677500,222,122,100
1243,21,385,2677600,0,0,0
1244,21,385,2677700,1292,655,637
1245,21,385,2677800,394,211,183
1246,21,385,2677900,1913,1018,895
1247,21,385,2678000,175,81,94
1248,21,385,2678100,503,278,225
1249,21,385,2678200,0,0,0
1250,21,385,2678300,31,11,20
1251,21,385,2678400,52,29,23
1252,21,385,2678500,687,351,336
1253,21,385,2678600,374,192,182
1254,21,385,2678700,471,250,221
1255,21,385,2678800,1356,673,683
1256,21,385,2678900,440,210,230
1257,21,385,2679000,551,271,280
1258,21,385,2679100,170,80,90
1259,21,385,2679200,420,205,215
1260,21,385,2679300,268,137,131
1261,21,385,2679400,644,334,310
1262,21,385,2679500,110,57,53
1263,21,385,2679600,336,180,156
1264,21,385,2679700,1568,822,746
1265,21,385,2679800,856,434,422
1266,21,385,2679900,44,25,19
1267,21,385,2680000,600,315,285
1268,21,385,2680100,582,314,268
1269,21,385,2680200,187,109,78
1270,21,385,2680300,665,341,324
1271,21,385,2680400,4484,2257,2227
1272,21,385,2680500,337,172,165
1273,21,385,2680600,138,72,66
1274,21,385,2680700,77,46,31
1275,21,385,2680800,1858,900,958
1276,21,385,2680900,692,347,345
1277,21,385,2681000,712,379,333
1278,21,385,2681100,0,0,0
1279,21,385,2681200,763,403,360
1280,21,385,2681300,253,120,133
1281,21,385,2681400,529,269,260
1282,21,385,2681500,824,445,379
1283,21,385,2681600,2489,1254,1235
1284,21,385,2681700,250,134,116
1285,21,385,2681800,241,117,124
1286,21,385,2681900,152,78,74
1287,21,385,2682000,100,51,49
1288,21,385,2682100,102,48,54
1289,21,385,2682200,458,243,215
1290,21,385,2682300,577,285,292
1291,21,385,2682400,1790,912,878
1292,21,385,2682500,517,275,242
1293,21,385,2682600,246,135,111
1294,21,385,2682700,2980,1584,1396
1295,21,385,2682800,4725,2431,2294
1296,21,385,2682900,235,123,112
1297,21,385,2683000,539,295,244
1298,21,385,2683100,843,462,381
1299,21,385,2683200,331,179,152
1300,21,385,2683300,1588,849,739
1301,21,385,2683400,40,21,19
1302,21,385,2683500,389,213,176
1303,21,385,2683600,3464,1837,1627
1304,21,385,2683700,360,192,168
1305,21,385,2683800,429,210,219
1306,21,385,2683900,1190,623,567
1307,21,385,2684000,506,262,244
1308,21,385,2684100,220,117,103
1309,21,385,2684200,184,96,88
1310,21,385,2684300,288,153,135
1311,21,385,2684400,308,165,143
1312,21,385,2684500,198,98,100
1313,21,385,2684600,472,250,222
1314,21,385,2684700,123,67,56
1315,21,385,2684800,0,0,0
1316,21,385,2684900,0,0,0
1317,21,385,2685000,47,20,27
1318,21,385,2685100,0,0,0
1319,21,385,2685200,1189,592,597
1320,21,385,2685300,1004,498,506
1321,21,385,2685400,459,220,239
1322,21,385,2685500,208,106,102
1323,21,385,2685600,17,9,8
1324,21,385,2685700,96,48,48
1325,21,385,2685800,564,287,277
1326,21,385,2685900,16,8,8
1327,21,385,2686000,0,0,0
1328,21,385,2686100,125,61,64
1329,21,385,2686200,404,199,205
1330,21,385,2686300,1225,647,578
1331,21,385,2686400,92,49,43
1332,21,385,2686500,530,277,253
1333,21,385,2686600,0,0,0
1334,21,385,2686700,76,40,36
1335,21,385,2686800,39,22,17
1336,21,385,2686900,182,99,83
1337,21,385,2687000,6,3,3
1338,21,385,2687100,259,138,121
1339,21,385,2687200,193,97,96
1340,21,385,2687300,570,297,273
1341,21,385,2687400,76,40,36
1342,21,385,2687500,0,0,0
1343,21,385,2687600,19,7,12
1344,21,385,2687700,115,58,57
1345,21,385,2687800,205,107,98
1346,21,385,2687900,51,24,27
1347,21,385,2688000,143,65,78
1348,21,385,2688100,95,46,49
1349,21,385,2688200,81,56,25
1350,21,385,2688300,86,42,44
1351,21,385,2688400,103,51,52
1352,21,385,2688500,117,56,61
1353,21,385,2688600,26,14,12
1354,21,385,2688700,355,187,168
1355,21,385,2688800,709,367,342
1356,21,385,2688900,96,53,43
1357,21,385,2689000,0,0,0
1358,21,385,2689100,47,25,22
1359,21,385,2689200,37,16,21
1360,21,385,2689300,265,136,129
1361,21,385,2689400,1693,873,820
1362,21,385,2689500,567,294,273
1363,21,385,2689600,413,208,205
1364,21,385,2689700,1186,618,568
1365,21,385,2689800,677,346,331
1366,21,385,2689900,976,521,455
1367,21,385,2690000,612,306,306
1368,21,385,2690100,0,0,0
1369,21,385,2690200,1193,606,587
1370,21,385,2690300,1343,702,641
1371,21,385,2690400,705,362,343
1372,21,385,2690500,663,351,312
1373,21,385,2690600,633,305,328
1374,21,385,2690700,3151,1655,1496
1375,21,385,2690800,1208,625,583
1376,21,385,2690900,702,364,338
1377,21,385,2691000,649,346,303
1378,21,385,2691100,930,477,453
1379,21,385,2691200,169,93,76
1380,21,385,2691300,1427,736,691
1381,21,385,2691400,304,163,141
1382,21,385,2691500,530,259,271
1383,21,385,2691600,417,217,200
1384,21,385,2691700,1391,712,679
1385,21,385,2691800,80,40,40
1386,21,385,2691900,16,8,8
1387,21,385,2692000,820,400,420
1388,21,385,2692100,650,330,320
1389,21,385,2692200,118,47,71
1390,21,385,2692300,279,144,135
1391,21,385,2692400,517,275,242
1392,21,385,2692500,973,517,456
1393,21,385,2692600,3226,1647,1579
1394,21,385,2692700,0,0,0
1395,21,385,2692800,947,493,454
1396,21,385,2692900,635,323,312
1397,21,385,2693000,1192,617,575
1398,21,385,2693100,1074,576,498
1399,21,385,2693200,709,367,342
1400,21,385,2693300,3583,1867,1716
1401,21,385,2693400,580,299,281
1402,21,385,2693500,544,290,254
1403,21,385,2693600,988,505,483
1404,21,385,2693700,1917,967,950
1405,21,385,2693800,1601,819,782
1406,21,385,2693900,1193,613,580
1407,21,385,2694000,188,100,88
1408,21,385,2694100,608,343,265
1409,21,385,2694200,519,259,260
1410,21,385,2694300,3676,1950,1726
1411,21,385,2694400,1046,547,499
1412,21,385,2694500,1063,535,528
1413,21,385,2694600,733,384,349
1414,21,385,2694700,483,248,235
1415,21,385,2694800,0,0,0
1416,21,385,2694900,1254,675,579
1417,21,385,2695000,396,194,202
1418,21,385,2695100,487,234,253
1419,21,385,2695200,293,155,138
1420,21,385,2695300,0,0,0
1421,21,385,2695400,180,87,93
1422,21,385,2695500,36,19,17
1423,21,385,2695600,1208,645,563
1424,21,385,2695700,927,489,438
1425,21,385,2695800,2668,1407,1261
1426,21,385,2695900,548,303,245
1427,21,385,2696000,2126,1134,992
1428,21,385,2696100,1682,875,807
1429,21,385,2696200,4195,2223,1972
1430,21,385,2696300,970,515,455
1431,21,385,2696400,241,126,115
1432,21,385,2696500,549,283,266
1433,21,385,2696600,624,325,299
1434,21,385,2696700,1217,609,608
1435,21,385,2696800,260,134,126
1436,21,385,2696900,493,269,224
1437,21,385,2697000,271,143,128
1438,21,385,2697100,877,439,438
1439,21,385,2697200,966,528,438
1440,21,385,2697300,3126,1625,1501
1441,21,385,2697400,49,26,23
1442,21,385,2697500,348,191,157
1443,21,385,2697600,78,36,42
1444,21,385,2697700,0,0,0
1445,21,385,2697800,111,62,49
1446,21,385,2697900,103,50,53
1447,21,385,2698000,37,19,18
1448,21,385,2698100,150,73,77
1449,21,385,2698200,378,197,181
1450,21,385,2698300,280,135,145
1451,21,385,2698400,53,28,25
1452,21,385,2698500,195,96,99
1453,21,385,2698600,0,0,0
1454,21,385,2698700,70,32,38
1455,21,385,2698800,610,307,303
1456,21,385,2698900,911,460,451
1457,21,385,2699000,833,424,409
1458,21,385,2699100,1251,654,597
1459,21,385,2699200,2191,1151,1040
1460,21,385,2699300,954,490,464
1461,21,385,2699400,164,78,86
1462,21,385,2699500,19,9,10
1463,21,385,2699600,0,0,0
1464,21,385,2699700,108,43,65
1465,21,385,2699800,32,16,16
1466,21,385,2699900,0,0,0
1467,21,385,2700000,126,67,59
1468,21,385,2700100,317,179,138
1469,21,385,2700200,633,331,302
1470,21,385,2700300,57,30,27
1471,21,385,2700400,112,59,53
1472,21,385,2700500,847,425,422
1473,21,385,2700600,4965,2547,2418
1474,21,385,2700700,0,0,0
1475,21,385,2700800,1404,707,697
1476,21,385,2700900,587,293,294
1477,21,385,2701000,609,310,299
1478,21,385,2701100,1393,727,666
1479,21,385,2701200,18,9,9
1480,21,385,2701300,1127,557,570
1481,21,385,2701400,37,20,17
1482,21,385,2701500,624,308,316
1483,21,385,2701600,12,8,4
1484,21,385,2701700,548,282,266
1485,21,385,2701800,1126,562,564
1486,21,385,2701900,260,134,126
1487,21,385,2702000,195,99,96
1488,21,385,2702100,475,243,232
1489,21,385,2702200,244,130,114
1490,21,385,2702300,323,153,170
1491,21,385,2702400,1079,549,530
1492,21,385,2702500,259,137,122
1493,21,385,2702600,154,83,71
1494,21,385,2702700,59,32,27
1495,21,385,2702800,0,0,0
1496,21,385,2702900,67,32,35
1497,21,385,2703000,15,9,6
1498,21,385,2703100,284,140,144
1499,21,385,2703200,665,340,325
1500,21,385,2703300,0,0,0
1501,21,385,2703400,98,48,50
1502,21,385,2703500,60,26,34
1503,21,385,2703600,38,18,20
1504,21,385,2703700,47,25,22
1505,21,385,2703800,1277,665,612
1506,21,385,2703900,1029,510,519
1507,21,385,2704000,192,96,96
1508,21,385,2704100,765,356,409
1509,21,385,2704200,202,98,104
1510,21,385,2704300,227,108,119
1511,21,385,2704400,65,33,32
1512,21,385,2704500,2,0,2
1513,21,385,2704600,563,288,275
1514,21,385,2704700,184,94,90
1515,21,385,2704800,12,6,6
1516,21,385,2704900,453,238,215
1517,21,385,2705000,1365,692,673
1518,21,385,2705100,205,88,117
1519,21,385,2705200,301,154,147
1520,21,385,2705300,2,1,1
1521,21,385,2705400,132,69,63
1522,21,385,2705500,777,386,391
1523,21,385,2705600,973,496,477
1524,21,385,2705700,163,71,92
1525,21,385,2705800,205,97,108
1526,21,385,2705900,0,0,0
1527,21,385,2706000,243,116,127
1528,21,385,2706100,1103,527,576
1529,21,385,2706200,262,138,124
1530,21,385,2706300,86,42,44
1531,21,385,2706400,168,86,82
1532,21,385,2706500,106,58,48
1533,21,385,2706600,533,245,288
1534,21,385,2706700,163,79,84
1535,21,385,2706800,336,169,167
1536,21,385,2706900,217,100,117
1537,21,385,2707000,314,164,150
1538,21,385,2707100,926,478,448
1539,21,385,2707200,296,146,150
1540,21,385,2707300,423,224,199
1541,21,385,2707400,15,8,7
1542,21,385,2707500,507,253,254
1543,21,385,2707600,384,192,192
1544,21,385,2707700,643,307,336
1545,21,385,2707800,104,54,50
1546,21,385,2707900,1175,587,588
1547,21,385,2708000,545,291,254
1548,21,385,2708100,1123,555,568
1549,21,385,2708200,293,144,149
1550,21,385,2708300,711,366,345
1551,21,385,2708400,389,201,188
1552,21,385,2708500,509,258,251
1553,21,385,2708600,393,200,193
1554,21,385,2708700,625,309,316
1555,21,385,2708800,190,94,96
1556,21,385,2708900,776,405,371
1557,21,385,2709000,1048,513,535
1558,21,385,2709100,273,143,130
1559,21,385,2709200,230,115,115
1560,21,385,2709300,579,298,281
1561,21,385,2709400,265,120,145
1562,21,385,2709500,166,80,86
1563,21,385,2709600,1342,680,662
1564,21,385,2709700,177,86,91
1565,21,385,2709800,12,5,7
1566,21,385,2709900,277,143,134
1567,21,385,2710000,488,249,239
1568,21,385,2710100,125,63,62
1569,21,385,2710200,413,211,202
1570,21,385,2710300,263,126,137
1571,21,385,2710400,240,115,125
1572,21,385,2710500,300,144,156
1573,21,385,2710600,273,140,133
1574,21,385,2710700,0,0,0
1575,21,385,2710800,445,196,249
1576,21,385,2710900,155,84,71
1577,21,385,2711000,867,450,417
1578,21,385,2711100,29,18,11
1579,21,385,2711200,8180,4185,3995
1580,21,385,2711300,62,31,31
1581,21,385,2711400,197,101,96
1582,21,385,2711500,133,63,70
1583,21,385,2711600,113,56,57
1584,21,385,2711700,620,315,305
1585,21,385,2711800,355,184,171
1586,21,385,2711900,369,192,177
1587,21,385,2712000,615,307,308
1588,21,385,2712100,202,108,94
1589,21,385,2712200,316,169,147
1590,21,385,2712300,210,105,105
1591,21,385,2712400,552,266,286
1592,21,385,2712500,684,352,332
1593,21,385,2712600,477,229,248
1594,21,385,2712700,450,231,219
1595,21,385,2712800,125,59,66
1596,21,385,2712900,62,37,25
1597,21,385,2713000,338,172,166
1598,21,385,2713100,690,353,337
1599,21,385,2713200,423,218,205
1600,21,385,2713300,538,266,272
1601,21,385,2713400,232,116,116
1602,21,385,2713500,660,347,313
1603,21,385,2713600,460,230,230
1604,21,385,2713700,1052,528,524
1605,21,385,2713800,486,231,255
1606,21,385,2713900,1376,726,650
1607,21,385,2714000,364,187,177
1608,21,385,2714100,650,335,315
1609,21,385,2714200,1043,513,530
1610,21,385,2714300,871,448,423
1611,21,385,2714400,39,22,17
1612,21,385,2714500,1678,837,841
1613,21,385,2714600,1124,558,566
1614,21,385,2714700,647,315,332
1615,21,385,2714800,632,317,315
1616,21,385,2714900,2142,1052,1090
1617,21,385,2715000,423,211,212
1618,21,385,2715100,1085,564,521
1619,21,385,2715200,212,107,105
1620,21,385,2715300,260,129,131
1621,21,385,2715400,734,377,357
1622,21,385,2715500,402,202,200
1623,21,385,2715600,778,390,388
1624,21,385,2715700,558,287,271
1625,21,385,2715800,128,70,58
1626,21,385,2715900,77,44,33
1627,21,385,2716000,394,199,195
1628,21,385,2716100,181,87,94
1629,21,385,2716200,3786,1944,1842
1630,21,385,2716300,554,298,256
1631,21,385,2716400,846,457,389
1632,21,385,2716500,202,104,98
1633,21,385,2716600,613,312,301
1634,21,385,2716700,654,315,339
1635,21,385,2716800,604,311,293
1636,21,385,2716900,992,490,502
1637,21,385,2717000,1509,743,766
1638,21,385,2717100,166,84,82
1639,21,385,2717200,362,188,174
1640,21,385,2717300,269,135,134
1641,21,385,2717400,587,302,285
1642,21,385,2717500,2757,1389,1368
1643,21,385,2717600,120,49,71
1644,21,385,2717700,868,423,445
1645,21,385,2717800,13,5,8
1646,21,385,2717900,41,19,22
1647,21,385,2718000,48,28,20
1648,21,385,2718100,23,12,11
1649,21,385,2718200,31,13,18
1650,21,385,2718300,66,31,35
1651,21,385,2718400,2,0,2
1652,21,385,2718500,31,14,17
1653,21,385,2718600,77,40,37
1654,21,385,2718700,30,16,14
1655,21,385,2718800,65,34,31
1656,21,385,2718900,79,33,46
1657,21,385,2719000,64,28,36
1658,21,385,2719100,37,16,21
1659,21,385,2719200,37,19,18
1660,21,385,2719300,452,212,240
1661,21,385,2719400,109,58,51
1662,21,385,2719500,142,73,69
1663,21,385,2719600,24,7,17
1664,21,385,2719700,72,38,34
1665,21,385,2719800,281,134,147
1666,21,385,2719900,156,86,70
1667,21,385,2720000,202,107,95
1668,21,385,2720100,206,108,98
1669,21,385,2720200,113,63,50
1670,21,385,2720300,399,195,204
1671,21,385,2720400,363,178,185
1672,21,385,2720500,1121,519,602
1673,21,385,2720600,314,144,170
1674,21,385,2720700,331,153,178
1675,21,385,2720800,142,64,78
1676,21,385,2720900,398,197,201
1677,21,385,2721000,44,22,22
1678,21,385,2721100,199,101,98
1679,21,385,2721200,79,35,44
1680,21,385,2721300,987,513,474
1681,21,385,2721400,837,419,418
1682,21,385,2721500,677,331,346
1683,21,385,2721600,711,371,340
1684,21,385,2721700,677,345,332
1685,21,385,2721800,673,348,325
1686,21,385,2721900,752,375,377
1687,21,385,2722000,3605,1848,1757
1688,21,385,2722100,427,219,208
1689,21,385,2722200,309,151,158
1690,21,385,2722300,983,519,464
1691,21,385,2722400,489,250,239
1692,21,385,2722500,1268,639,629
1693,21,385,2722600,610,321,289
1694,21,385,2722700,556,283,273
