,Statecode,Districtcode,VillageCode,Population,Males,Females
0,21,388,3049400,769,380,389
1,21,388,3049500,139,71,68
2,21,388,3049600,61,28,33
3,21,388,3049700,87,44,43
4,21,388,3049800,382,205,177
5,21,388,3049900,133,67,66
6,21,388,3050000,106,54,52
7,21,388,3050100,110,56,54
8,21,388,3050200,931,541,390
9,21,388,3050300,277,131,146
10,21,388,3050400,88,45,43
11,21,388,3050500,196,91,105
12,21,388,3050600,547,279,268
13,21,388,3050700,749,393,356
14,21,388,3050800,1784,899,885
15,21,388,3050900,592,292,300
16,21,388,3051000,224,117,107
17,21,388,3051100,290,164,126
18,21,388,3051200,2718,1392,1326
19,21,388,3051300,572,292,280
20,21,388,3051400,897,431,466
21,21,388,3051500,406,201,205
22,21,388,3051600,1212,625,587
23,21,388,3051700,178,93,85
24,21,388,3051800,363,199,164
25,21,388,3051900,868,437,431
26,21,388,3052000,727,354,373
27,21,388,3052100,2456,1240,1216
28,21,388,3052200,882,437,445
29,21,388,3052300,1753,890,863
30,21,388,3052400,18,10,8
31,21,388,3052500,505,255,250
32,21,388,3052600,1118,571,547
33,21,388,3052700,479,239,240
34,21,388,3052800,672,336,336
35,21,388,3052900,46,18,28
36,21,388,3053000,1485,734,751
37,21,388,3053100,525,287,238
38,21,388,3053200,3688,1859,1829
39,21,388,3053300,377,196,181
40,21,388,3053400,1452,721,731
41,21,388,3053500,251,126,125
42,21,388,3053600,547,289,258
43,21,388,3053700,1520,798,722
44,21,388,3053800,283,141,142
45,21,388,3053900,1371,680,691
46,21,388,3054000,398,195,203
47,21,388,3054100,798,375,423
48,21,388,3054200,1219,627,592
49,21,388,3054300,319,159,160
50,21,388,3054400,1,0,1
51,21,388,3054500,834,411,423
52,21,388,3054600,631,319,312
53,21,388,3054700,267,137,130
54,21,388,3054800,387,184,203
55,21,388,3054900,1731,880,851
56,21,388,3055000,497,235,262
57,21,388,3055100,243,121,122
58,21,388,3055200,448,219,229
59,21,388,3055300,1425,665,760
60,21,388,3055400,0,0,0
61,21,388,3055500,24,12,12
62,21,388,3055600,46,21,25
63,21,388,3055700,321,162,159
64,21,388,3055800,41,16,25
65,21,388,3055900,1,0,1
66,21,388,3056000,6,3,3
67,21,388,3056100,639,306,333
68,21,388,3056200,0,0,0
69,21,388,3056300,45,23,22
70,21,388,3056400,667,336,331
71,21,388,3056500,389,189,200
72,21,388,3056600,253,130,123
73,21,388,3056700,455,238,217
74,21,388,3056800,55,27,28
75,21,388,3056900,532,259,273
76,21,388,3057000,1364,630,734
77,21,388,3057100,1035,507,528
78,21,388,3057200,1199,609,590
79,21,388,3057300,13,6,7
80,21,388,3057400,1206,588,618
81,21,388,3057500,244,129,115
82,21,388,3057600,854,417,437
83,21,388,3057700,301,133,168
84,21,388,3057800,48,24,24
85,21,388,3057900,0,0,0
86,21,388,3058000,270,143,127
87,21,388,3058100,4274,2140,2134
88,21,388,3058200,74,37,37
89,21,388,3058300,301,151,150
90,21,388,3058400,293,150,143
91,21,388,3058500,672,356,316
92,21,388,3058600,78,37,41
93,21,388,3058700,6,3,3
94,21,388,3058800,552,260,292
95,21,388,3058900,618,315,303
96,21,388,3059000,674,317,357
97,21,388,3059100,275,143,132
98,21,388,3059200,1093,509,584
99,21,388,3059300,342,176,166
100,21,388,3059400,65,23,42
101,21,388,3059500,241,113,128
102,21,388,3059600,1087,545,542
103,21,388,3059700,405,191,214
104,21,388,3059800,798,405,393
105,21,388,3059900,566,287,279
106,21,388,3060000,348,166,182
107,21,388,3060100,207,102,105
108,21,388,3060200,51,29,22
109,21,388,3060300,61,28,33
110,21,388,3060400,184,93,91
111,21,388,3060500,518,260,258
112,21,388,3060600,1156,596,560
113,21,388,3060700,156,79,77
114,21,388,3060800,155,74,81
115,21,388,3060900,2382,1179,1203
116,21,388,3061000,1912,955,957
117,21,388,3061100,581,295,286
118,21,388,3061200,172,92,80
119,21,388,3061300,287,146,141
120,21,388,3061400,566,287,279
121,21,388,3061500,383,181,202
122,21,388,3061600,1667,822,845
123,21,388,3061700,429,203,226
124,21,388,3061800,678,324,354
125,21,388,3061900,524,275,249
126,21,388,3062000,100,53,47
127,21,388,3062100,381,186,195
128,21,388,3062200,47,25,22
129,21,388,3062300,81,44,37
130,21,388,3062400,0,0,0
131,21,388,3062500,0,0,0
132,21,388,3062600,22,12,10
133,21,388,3062700,1073,553,520
134,21,388,3062800,87,41,46
135,21,388,3062900,3734,1921,1813
136,21,388,3063000,6,3,3
137,21,388,3063100,1774,886,888
138,21,388,3063200,1231,613,618
139,21,388,3063300,329,162,167
140,21,388,3063400,502,256,246
141,21,388,3063500,1605,821,784
142,21,388,3063600,291,142,149
143,21,388,3063700,39,16,23
144,21,388,3063800,486,239,247
145,21,388,3063900,1183,577,606
146,21,388,3064000,483,235,248
147,21,388,3064100,1748,853,895
148,21,388,3064200,2964,1540,1424
149,21,388,3064300,48,27,21
150,21,388,3064400,218,106,112
151,21,388,3064500,2172,1062,1110
152,21,388,3064600,1567,771,796
153,21,388,3064700,162,84,78
154,21,388,3064800,140,74,66
155,21,388,3064900,206,100,106
156,21,388,3065000,254,131,123
157,21,388,3065100,140,65,75
158,21,388,3065200,501,248,253
159,21,388,3065300,1029,515,514
160,21,388,3065400,774,367,407
161,21,388,3065500,280,142,138
162,21,388,3065600,512,235,277
163,21,388,3065700,497,244,253
164,21,388,3065800,586,301,285
165,21,388,3065900,2621,1263,1358
166,21,388,3066000,415,205,210
167,21,388,3066100,649,299,350
168,21,388,3066200,1250,603,647
169,21,388,3066300,886,423,463
170,21,388,3066400,824,400,424
171,21,388,3066500,617,322,295
172,21,388,3066600,1249,616,633
173,21,388,3066700,860,409,451
174,21,388,3066800,1245,623,622
175,21,388,3066900,662,345,317
176,21,388,3067000,796,404,392
177,21,388,3067100,553,267,286
178,21,388,3067200,893,459,434
179,21,388,3067300,735,318,417
180,21,388,3067400,229,118,111
181,21,388,3067500,1043,468,575
182,21,388,3067600,1068,518,550
183,21,388,3067700,933,440,493
184,21,388,3067800,985,489,496
185,21,388,3067900,2662,1294,1368
186,21,388,3068000,655,343,312
187,21,388,3068100,14,6,8
188,21,388,3068200,79,34,45
189,21,388,3068300,743,388,355
190,21,388,3068400,318,155,163
191,21,388,3068500,134,65,69
192,21,388,3068600,2282,1112,1170
193,21,388,3068700,1118,555,563
194,21,388,3068800,371,185,186
195,21,388,3068900,0,0,0
196,21,388,3069000,593,299,294
197,21,388,3069100,30,16,14
198,21,388,3069200,264,139,125
199,21,388,3069300,166,81,85
200,21,388,3069400,1121,602,519
201,21,388,3069500,27,15,12
202,21,388,3069600,726,373,353
203,21,388,3069700,1477,730,747
204,21,388,3069800,1076,527,549
205,21,388,3069900,949,468,481
206,21,388,3070000,0,0,0
207,21,388,3070100,582,279,303
208,21,388,3070200,1024,467,557
209,21,388,3070300,1065,510,555
210,21,388,3070400,1740,808,932
211,21,388,3070500,490,229,261
212,21,388,3070600,0,0,0
213,21,388,3070700,1038,501,537
214,21,388,3070800,2329,1122,1207
215,21,388,3070900,1124,540,584
216,21,388,3071000,1283,569,714
217,21,388,3071100,1505,730,775
218,21,388,3071200,266,131,135
219,21,388,3071300,1089,568,521
220,21,388,3071400,1063,508,555
221,21,388,3071500,1550,820,730
222,21,388,3071600,1273,648,625
223,21,388,3071700,0,0,0
224,21,388,3071800,2417,1156,1261
225,21,388,3071900,0,0,0
226,21,388,3072000,803,392,411
227,21,388,3072100,1264,638,626
228,21,388,3072200,672,349,323
229,21,388,3072300,1286,597,689
230,21,388,3072400,1309,652,657
231,21,388,3072500,1092,531,561
232,21,388,3072600,344,183,161
233,21,388,3072700,63,31,32
234,21,388,3072800,147,73,74
235,21,388,3072900,42,19,23
236,21,388,3073000,0,0,0
237,21,388,3073100,126,62,64
238,21,388,3073200,186,93,93
239,21,388,3073300,141,75,66
240,21,388,3073400,484,266,218
241,21,388,3073500,2730,1386,1344
242,21,388,3073600,1847,933,914
243,21,388,3073700,0,0,0
244,21,388,3073800,1196,594,602
245,21,388,3073900,805,409,396
246,21,388,3074000,401,201,200
247,21,388,3074100,970,462,508
248,21,388,3074200,394,188,206
249,21,388,3074300,1975,965,1010
250,21,388,3074400,863,416,447
251,21,388,3074500,1101,538,563
252,21,388,3074600,1301,606,695
253,21,388,3074700,1155,592,563
254,21,388,3074800,1652,804,848
255,21,388,3074900,699,351,348
256,21,388,3075000,995,493,502
257,21,388,3075100,87,42,45
258,21,388,3075200,4041,1992,2049
259,21,388,3075300,847,441,406
260,21,388,3075400,1230,607,623
261,21,388,3075500,259,124,135
262,21,388,3075600,98,48,50
263,21,388,3075700,48,19,29
264,21,388,3075800,224,110,114
265,21,388,3075900,334,158,176
266,21,388,3076000,588,281,307
267,21,388,3076100,276,144,132
268,21,388,3076200,289,139,150
269,21,388,3076300,409,215,194
270,21,388,3076400,1867,995,872
271,21,388,3076500,1810,894,916
272,21,388,3076600,347,171,176
273,21,388,3076700,55,29,26
274,21,388,3076800,655,306,349
275,21,388,3076900,340,168,172
276,21,388,3077000,53,24,29
277,21,388,3077100,3282,1631,1651
278,21,388,3077200,126,55,71
279,21,388,3077300,636,302,334
280,21,388,3077400,636,322,314
281,21,388,3077500,249,121,128
282,21,388,3077600,1073,524,549
283,21,388,3077700,255,121,134
284,21,388,3077800,69,32,37
285,21,388,3077900,500,243,257
286,21,388,3078000,650,333,317
287,21,388,3078100,43,20,23
288,21,388,3078200,256,130,126
289,21,388,3078300,1151,580,571
290,21,388,3078400,462,238,224
291,21,388,3078500,135,66,69
292,21,388,3078600,295,153,142
293,21,388,3078700,730,359,371
294,21,388,3078800,319,160,159
295,21,388,3078900,267,134,133
296,21,388,3079000,130,67,63
297,21,388,3079100,405,193,212
298,21,388,3079200,1693,839,854
299,21,388,3079300,590,288,302
300,21,388,3079400,85,51,34
301,21,388,3079500,93,47,46
302,21,388,3079600,195,100,95
303,21,388,3079700,0,0,0
304,21,388,3079800,592,286,306
305,21,388,3079900,224,112,112
306,21,388,3080000,584,308,276
307,21,388,3080100,99,50,49
308,21,388,3080200,702,359,343
309,21,388,3080300,535,275,260
310,21,388,3080400,137,71,66
311,21,388,3080500,954,443,511
312,21,388,3080600,1086,542,544
313,21,388,3080700,872,435,437
314,21,388,3080800,591,295,296
315,21,388,3080900,511,252,259
316,21,388,3081000,1426,742,684
317,21,388,3081100,758,365,393
318,21,388,3081200,1109,581,528
319,21,388,3081300,721,362,359
320,21,388,3081400,1111,544,567
321,21,388,3081500,500,262,238
322,21,388,3081600,0,0,0
323,21,388,3081700,1016,511,505
324,21,388,3081800,4316,2171,2145
325,21,388,3081900,1043,534,509
326,21,388,3082000,5614,2934,2680
327,21,388,3082100,0,0,0
328,21,388,3082200,0,0,0
329,21,388,3082300,2006,986,1020
330,21,388,3082400,189,93,96
331,21,388,3082500,495,236,259
332,21,388,3082600,1870,930,940
333,21,388,3082700,594,295,299
334,21,388,3082800,328,156,172
335,21,388,3082900,1370,691,679
336,21,388,3083000,550,255,295
337,21,388,3083100,168,86,82
338,21,388,3083200,207,102,105
339,21,388,3083300,27,14,13
340,21,388,3083400,1079,584,495
341,21,388,3083500,376,203,173
342,21,388,3083600,406,210,196
343,21,388,3083700,1267,620,647
344,21,388,3083800,387,174,213
345,21,388,3083900,3006,1422,1584
346,21,388,3084000,1133,568,565
347,21,388,3084100,2430,1205,1225
348,21,388,3084200,426,206,220
349,21,388,3084300,880,441,439
350,21,388,3084400,2503,1261,1242
351,21,388,3084500,1105,559,546
352,21,388,3084600,2380,1213,1167
353,21,388,3084700,854,403,451
354,21,388,3084800,2543,1314,1229
355,21,388,3084900,529,275,254
356,21,388,3085000,181,89,92
357,21,388,3085100,0,0,0
358,21,388,3085200,904,462,442
359,21,388,3085300,239,124,115
360,21,388,3085400,1430,702,728
361,21,388,3085500,60,32,28
362,21,388,3085600,0,0,0
363,21,388,3085700,84,42,42
364,21,388,3085800,0,0,0
365,21,388,3085900,111,55,56
366,21,388,3086000,119,62,57
367,21,388,3086100,439,214,225
368,21,388,3086200,1107,567,540
369,21,388,3086300,1030,530,500
370,21,388,3086400,323,147,176
371,21,388,3086500,1236,593,643
372,21,388,3086600,1736,856,880
373,21,388,3086700,1492,678,814
374,21,388,3086800,1271,607,664
375,21,388,3086900,428,221,207
376,21,388,3087000,625,292,333
377,21,388,3087100,774,374,400
378,21,388,3087200,1438,705,733
379,21,388,3087300,864,430,434
380,21,388,3087400,142,62,80
381,21,388,3087500,483,221,262
382,21,388,3087600,262,125,137
383,21,388,3087700,824,405,419
384,21,388,3087800,1469,724,745
385,21,388,3087900,1701,850,851
386,21,388,3088000,456,226,230
387,21,388,3088100,605,300,305
388,21,388,3088200,1143,528,615
389,21,388,3088300,2080,1018,1062
390,21,388,3088400,487,226,261
391,21,388,3088500,1197,580,617
392,21,388,3088600,210,104,106
393,21,388,3088700,1690,801,889
394,21,388,3088800,1272,630,642
395,21,388,3088900,987,471,516
396,21,388,3089000,1121,520,601
397,21,388,3089100,522,241,281
398,21,388,3089200,1451,712,739
399,21,388,3089300,647,304,343
400,21,388,3089400,0,0,0
401,21,388,3089500,1368,660,708
402,21,388,3089600,13,6,7
403,21,388,3089700,2807,1336,1471
404,21,388,3089800,411,188,223
405,21,388,3089900,1430,674,756
406,21,388,3090000,418,212,206
407,21,388,3090100,1682,793,889
408,21,388,3090200,1739,863,876
409,21,388,3090300,413,203,210
410,21,388,3090400,200,103,97
411,21,388,3090500,252,124,128
412,21,388,3090600,401,204,197
413,21,388,3090700,886,454,432
414,21,388,3090800,330,169,161
415,21,388,3090900,561,273,288
416,21,388,3091000,1938,943,995
417,21,388,3091100,1481,740,741
418,21,388,3091200,934,439,495
419,21,388,3091300,1959,907,1052
420,21,388,3091400,552,272,280
421,21,388,3091500,294,156,138
422,21,388,3091600,2552,1294,1258
423,21,388,3091700,412,200,212
424,21,388,3091800,757,379,378
425,21,388,3091900,897,443,454
426,21,388,3092000,252,137,115
427,21,388,3092100,16,11,5
428,21,388,3092200,720,364,356
429,21,388,3092300,1296,586,710
430,21,388,3092400,357,177,180
431,21,388,3092500,258,121,137
432,21,388,3092600,1558,687,871
433,21,388,3092700,930,446,484
434,21,388,3092800,492,224,268
435,21,388,3092900,1280,576,704
436,21,388,3093000,737,343,394
437,21,388,3093100,1144,570,574
438,21,388,3093200,601,301,300
439,21,388,3093300,1911,985,926
440,21,388,3093400,321,155,166
441,21,388,3093500,595,306,289
442,21,388,3093600,527,227,300
443,21,388,3093700,847,401,446
444,21,388,3093800,1686,773,913
445,21,388,3093900,2235,1107,1128
446,21,388,3094000,612,307,305
447,21,388,3094100,746,388,358
448,21,388,3094200,473,224,249
449,21,388,3094300,1524,762,762
450,21,388,3094400,317,155,162
451,21,388,3094500,966,468,498
452,21,388,3094600,1399,697,702
453,21,388,3094700,1914,918,996
454,21,388,3094800,1717,830,887
455,21,388,3094900,1890,911,979
456,21,388,3095000,612,290,322
457,21,388,3095100,1102,522,580
458,21,388,3095200,483,236,247
459,21,388,3095300,555,253,302
460,21,388,3095400,2219,1036,1183
461,21,388,3095500,630,299,331
462,21,388,3095600,2416,1196,1220
463,21,388,3095700,986,482,504
464,21,388,3095800,2509,1187,1322
465,21,388,3095900,1133,601,532
466,21,388,3096000,1129,518,611
467,21,388,3096100,276,142,134
468,21,388,3096200,2461,1201,1260
469,21,388,3096300,1186,550,636
470,21,388,3096400,1475,688,787
471,21,388,3096500,1182,551,631
472,21,388,3096600,927,436,491
473,21,388,3096700,1869,884,985
474,21,388,3096800,231,116,115
475,21,388,3096900,2264,1059,1205
476,21,388,3097000,730,387,343
477,21,388,3097100,788,385,403
478,21,388,3097200,639,313,326
479,21,388,3097300,2475,1112,1363
480,21,388,3097400,1573,748,825
481,21,388,3097500,564,274,290
482,21,388,3097600,1145,531,614
483,21,388,3097700,441,223,218
484,21,388,3097800,4078,2054,2024
485,21,388,3097900,0,0,0
486,21,388,3098000,1315,624,691
487,21,388,3098100,1243,566,677
488,21,388,3098200,2398,1123,1275
489,21,388,3098300,1867,931,936
490,21,388,3098400,1316,589,727
491,21,388,3098500,549,240,309
492,21,388,3098600,1505,724,781
493,21,388,3098700,1030,513,517
494,21,388,3098800,0,0,0
495,21,388,3098900,0,0,0
496,21,388,3099000,218,103,115
497,21,388,3099100,832,392,440
498,21,388,3099200,0,0,0
499,21,388,3099300,0,0,0
500,21,388,3099400,489,213,276
501,21,388,3099500,416,207,209
502,21,388,3099600,31,16,15
503,21,388,3099700,2456,1157,1299
504,21,388,3099800,63,24,39
505,21,388,3099900,0,0,0
506,21,388,3100000,35,16,19
507,21,388,3100100,0,0,0
508,21,388,3100200,0,0,0
509,21,388,3100300,0,0,0
510,21,388,3100400,0,0,0
511,21,388,3100500,162,83,79
512,21,388,3100600,48,25,23
513,21,388,3100700,0,0,0
514,21,388,3100800,24,10,14
515,21,388,3100900,2925,1434,1491
516,21,388,3101000,1941,991,950
517,21,388,3101100,418,211,207
518,21,388,3101200,1068,527,541
519,21,388,3101300,0,0,0
520,21,388,3101400,0,0,0
521,21,388,3101500,1743,865,878
522,21,388,3101600,119,62,57
523,21,388,3101700,339,170,169
524,21,388,3101800,34,17,17
525,21,388,3101900,195,75,120
526,21,388,3102000,963,443,520
527,21,388,3102100,50,23,27
528,21,388,3102200,0,0,0
529,21,388,3102300,149,62,87
530,21,388,3102400,65,34,31
531,21,388,3102500,1080,537,543
532,21,388,3102600,26,12,14
533,21,388,3102700,98,46,52
534,21,388,3102800,165,91,74
535,21,388,3102900,187,83,104
536,21,388,3103000,359,166,193
537,21,388,3103100,658,314,344
538,21,388,3103200,91,38,53
539,21,388,3103300,47,24,23
540,21,388,3103400,206,111,95
541,21,388,3103500,61,26,35
542,21,388,3103600,0,0,0
543,21,388,3103700,137,64,73
544,21,388,3103800,27,15,12
545,21,388,3103900,512,237,275
546,21,388,3104000,687,309,378
547,21,388,3104100,123,64,59
548,21,388,3104200,2627,1331,1296
549,21,388,3104300,596,311,285
550,21,388,3104400,443,199,244
551,21,388,3104500,81,43,38
552,21,388,3104600,38,15,23
553,21,388,3104700,115,60,55
554,21,388,3104800,257,123,134
555,21,388,3104900,0,0,0
556,21,388,3105000,194,87,107
557,21,388,3105100,100,48,52
558,21,388,3105200,303,151,152
559,21,388,3105300,44,21,23
560,21,388,3105400,22,11,11
561,21,388,3105500,0,0,0
562,21,388,3105600,49,22,27
563,21,388,3105700,20,11,9
564,21,388,3105800,211,106,105
565,21,388,3105900,1261,679,582
566,21,388,3106000,0,0,0
567,21,388,3106100,272,140,132
568,21,388,3106200,195,104,91
569,21,388,3106300,0,0,0
570,21,388,3106400,248,125,123
571,21,388,3106500,451,234,217
572,21,388,3106600,905,489,416
573,21,388,3106700,0,0,0
574,21,388,3106800,0,0,0
575,21,388,3106900,77,36,41
576,21,388,3107000,146,81,65
577,21,388,3107100,0,0,0
578,21,388,3107200,78,39,39
579,21,388,3107300,574,280,294
580,21,388,3107400,45,23,22
581,21,388,3107500,72,35,37
582,21,388,3107600,748,371,377
583,21,388,3107700,849,435,414
584,21,388,3107800,449,224,225
585,21,388,3107900,318,150,168
586,21,388,3108000,148,68,80
587,21,388,3108100,4,1,3
588,21,388,3108200,133,69,64
589,21,388,3108300,596,292,304
590,21,388,3108400,209,118,91
591,21,388,3108500,1494,739,755
592,21,388,3108600,6,4,2
593,21,388,3108700,161,80,81
594,21,388,3108800,154,78,76
595,21,388,3108900,468,226,242
596,21,388,3109000,614,313,301
597,21,388,3109100,1039,498,541
598,21,388,3109200,243,118,125
599,21,388,3109300,474,222,252
600,21,388,3109400,1045,485,560
601,21,388,3109500,182,90,92
602,21,388,3109600,466,235,231
603,21,388,3109700,38,15,23
604,21,388,3109800,258,125,133
605,21,388,3109900,522,261,261
606,21,388,3110000,164,86,78
607,21,388,3110100,81,31,50
608,21,388,3110200,81,39,42
609,21,388,3110300,138,67,71
610,21,388,3110400,240,131,109
611,21,388,3110500,147,77,70
612,21,388,3110600,130,61,69
613,21,388,3110700,401,176,225
614,21,388,3110800,589,284,305
615,21,388,3110900,43,18,25
616,21,388,3111000,148,61,87
617,21,388,3111100,0,0,0
618,21,388,3111200,0,0,0
619,21,388,3111300,81,39,42
620,21,388,3111400,339,172,167
621,21,388,3111500,861,476,385
622,21,388,3111600,328,166,162
623,21,388,3111700,333,164,169
624,21,388,3111800,693,368,325
625,21,388,3111900,789,396,393
626,21,388,3112000,1801,913,888
627,21,388,3112100,305,149,156
628,21,388,3112200,157,81,76
629,21,388,3112300,879,461,418
630,21,388,3112400,1723,880,843
631,21,388,3112500,211,106,105
632,21,388,3112600,343,173,170
633,21,388,3112700,345,163,182
634,21,388,3112800,3004,1430,1574
635,21,388,3112900,1237,576,661
636,21,388,3113000,1561,748,813
637,21,388,3113100,903,441,462
638,21,388,3113200,1224,620,604
639,21,388,3113300,379,204,175
640,21,388,3113400,528,261,267
641,21,388,3113500,2475,1238,1237
642,21,388,3113600,6,1,5
643,21,388,3113700,52,24,28
644,21,388,3113800,975,477,498
645,21,388,3113900,51,24,27
646,21,388,3114000,176,89,87
647,21,388,3114100,1,0,1
648,21,388,3114200,49,23,26
649,21,388,3114300,68,37,31
650,21,388,3114400,274,143,131
651,21,388,3114500,0,0,0
652,21,388,3114600,917,458,459
653,21,388,3114700,184,86,98
654,21,388,3114800,288,152,136
655,21,388,3114900,562,285,277
656,21,388,3115000,0,0,0
657,21,388,3115100,446,219,227
658,21,388,3115200,1723,874,849
659,21,388,3115300,455,218,237
660,21,388,3115400,1653,849,804
661,21,388,3115500,30,14,16
662,21,388,3115600,734,362,372
663,21,388,3115700,1066,574,492
664,21,388,3115800,1918,906,1012
665,21,388,3115900,1567,767,800
666,21,388,3116000,2699,1345,1354
667,21,388,3116100,0,0,0
668,21,388,3116200,30,13,17
669,21,388,3116300,0,0,0
670,21,388,3116400,29,15,14
671,21,388,3116500,12,6,6
672,21,388,3116600,56,30,26
673,21,388,3116700,4,1,3
674,21,388,3116800,184,93,91
675,21,388,3116900,23,11,12
676,21,388,3117000,55,23,32
677,21,388,3117100,155,79,76
678,21,388,3117200,79,39,40
679,21,388,3117300,37,22,15
680,21,388,3117400,0,0,0
681,21,388,3117500,0,0,0
682,21,388,3117600,73,43,30
683,21,388,3117700,153,66,87
684,21,388,3117800,0,0,0
685,21,388,3117900,56,28,28
686,21,388,3118000,0,0,0
687,21,388,3118100,22,8,14
688,21,388,3118200,46,19,27
689,21,388,3118300,135,67,68
690,21,388,3118400,43,17,26
691,21,388,3118500,94,48,46
692,21,388,3118600,31,14,17
693,21,388,3118700,50,26,24
694,21,388,3118800,107,56,51
695,21,388,3118900,41,21,20
696,21,388,3119000,12,8,4
697,21,388,3119100,949,447,502
698,21,388,3119200,19,8,11
699,21,388,3119300,70,31,39
700,21,388,3119400,114,57,57
701,21,388,3119500,176,88,88
702,21,388,3119600,128,57,71
703,21,388,3119700,106,52,54
704,21,388,3119800,78,36,42
705,21,388,3119900,0,0,0
706,21,388,3120000,660,328,332
707,21,388,3120100,160,82,78
708,21,388,3120200,295,148,147
709,21,388,3120300,62,31,31
710,21,388,3120400,122,63,59
711,21,388,3120500,271,131,140
712,21,388,3120600,14,8,6
713,21,388,3120700,0,0,0
714,21,388,3120800,42,20,22
715,21,388,3120900,0,0,0
716,21,388,3121000,0,0,0
717,21,388,3121100,59,34,25
718,21,388,3121200,358,181,177
719,21,388,3121300,16,11,5
720,21,388,3121400,742,389,353
721,21,388,3121500,294,158,136
722,21,388,3121600,635,324,311
723,21,388,3121700,129,70,59
724,21,388,3121800,1028,518,510
725,21,388,3121900,173,84,89
726,21,388,3122000,1811,911,900
727,21,388,3122100,65,28,37
728,21,388,3122200,0,0,0
729,21,388,3122300,184,88,96
730,21,388,3122400,87,39,48
731,21,388,3122500,293,149,144
732,21,388,3122600,411,202,209
733,21,388,3122700,224,120,104
734,21,388,3122800,1618,783,835
735,21,388,3122900,1066,540,526
736,21,388,3123000,75,35,40
737,21,388,3123100,57,30,27
738,21,388,3123200,93,43,50
739,21,388,3123300,58,31,27
740,21,388,3123400,391,199,192
741,21,388,3123500,844,414,430
742,21,388,3123600,640,324,316
743,21,388,3123700,736,383,353
744,21,388,3123800,265,137,128
745,21,388,3123900,1348,701,647
746,21,388,3124000,103,49,54
747,21,388,3124100,590,312,278
748,21,388,3124200,197,101,96
749,21,388,3124300,205,116,89
750,21,388,3124400,206,99,107
751,21,388,3124500,1231,644,587
752,21,388,3124600,31,13,18
753,21,388,3124700,455,213,242
754,21,388,3124800,690,354,336
755,21,388,3124900,0,0,0
756,21,388,3125000,0,0,0
757,21,388,3125100,0,0,0
758,21,388,3125200,156,75,81
759,21,388,3125300,66,36,30
760,21,388,3125400,131,74,57
761,21,388,3125500,412,191,221
762,21,388,3125600,26,14,12
763,21,388,3125700,0,0,0
764,21,388,3125800,82,38,44
765,21,388,3125900,117,58,59
766,21,388,3126000,129,59,70
767,21,388,3126100,306,151,155
768,21,388,3126200,455,242,213
769,21,388,3126300,368,180,188
770,21,388,3126400,0,0,0
771,21,388,3126500,0,0,0
772,21,388,3126600,0,0,0
773,21,388,3126700,454,228,226
774,21,388,3126800,863,439,424
775,21,388,3126900,0,0,0
776,21,388,3127000,1324,698,626
777,21,388,3127100,726,369,357
778,21,388,3127200,1568,791,777
779,21,388,3127300,142,66,76
780,21,388,3127400,0,0,0
781,21,388,3127500,343,179,164
782,21,388,3127600,953,484,469
783,21,388,3127700,1533,813,720
784,21,388,3127800,36,16,20
785,21,388,3127900,2681,1369,1312
786,21,388,3128000,518,273,245
787,21,388,3128100,0,0,0
788,21,388,3128200,61,24,37
789,21,388,3128300,487,220,267
790,21,388,3128400,259,114,145
791,21,388,3128500,124,64,60
792,21,388,3128600,27,12,15
793,21,388,3128700,492,243,249
794,21,388,3128800,0,0,0
795,21,388,3128900,0,0,0
796,21,388,3129000,0,0,0
797,21,388,3129100,274,126,148
798,21,388,3129200,983,481,502
799,21,388,3129300,349,163,186
800,21,388,3129400,951,468,483
801,21,388,3129500,160,76,84
802,21,388,3129600,387,183,204
803,21,388,3129700,1138,564,574
804,21,388,3129800,536,258,278
805,21,388,3129900,2107,1098,1009
806,21,388,3130000,56,29,27
807,21,388,3130100,435,212,223
808,21,388,3130200,168,89,79
809,21,388,3130300,2649,1355,1294
810,21,388,3130400,590,296,294
811,21,388,3130500,0,0,0
812,21,388,3130600,100,49,51
813,21,388,3130700,33,17,16
814,21,388,3130800,5822,2960,2862
815,21,388,3130900,47,19,28
816,21,388,3131000,29,11,18
817,21,388,3131100,63,32,31
818,21,388,3131200,96,45,51
819,21,388,3131300,229,117,112
820,21,388,3131400,414,196,218
821,21,388,3131500,32,18,14
822,21,388,3131600,0,0,0
823,21,388,3131700,110,58,52
824,21,388,3131800,24,10,14
825,21,388,3131900,218,93,125
826,21,388,3132000,347,172,175
827,21,388,3132100,0,0,0
828,21,388,3132200,82,49,33
829,21,388,3132300,34,14,20
830,21,388,3132400,59,31,28
831,21,388,3132500,139,61,78
832,21,388,3132600,71,27,44
833,21,388,3132700,38,16,22
834,21,388,3132800,47,24,23
835,21,388,3132900,95,37,58
836,21,388,3133000,88,43,45
837,21,388,3133100,72,31,41
838,21,388,3133200,88,47,41
839,21,388,3133300,64,30,34
840,21,388,3133400,0,0,0
841,21,388,3133500,144,78,66
842,21,388,3133600,63,29,34
843,21,388,3133700,1761,893,868
844,21,388,3133800,345,159,186
845,21,388,3133900,184,84,100
846,21,388,3134000,123,58,65
847,21,388,3134100,100,53,47
848,21,388,3134200,148,72,76
849,21,388,3134300,74,39,35
850,21,388,3134400,110,56,54
851,21,388,3134500,46,24,22
852,21,388,3134600,156,73,83
853,21,388,3134700,216,101,115
854,21,388,3134800,98,49,49
855,21,388,3134900,231,128,103
856,21,388,3135000,115,56,59
857,21,388,3135100,264,128,136
858,21,388,3135200,1074,565,509
859,21,388,3135300,232,114,118
860,21,388,3135400,0,0,0
861,21,388,3135500,643,328,315
862,21,388,3135600,0,0,0
863,21,388,3135700,0,0,0
864,21,388,3135800,1836,866,970
865,21,388,3135900,56,28,28
866,21,388,3136000,446,226,220
867,21,388,3136100,1856,943,913
868,21,388,3136200,408,217,191
869,21,388,3136300,71,34,37
870,21,388,3136400,0,0,0
871,21,388,3136500,58,32,26
872,21,388,3136600,87,43,44
873,21,388,3136700,147,70,77
874,21,388,3136800,339,172,167
875,21,388,3136900,0,0,0
876,21,388,3137000,0,0,0
877,21,388,3137100,145,72,73
878,21,388,3137200,163,80,83
879,21,388,3137300,247,131,116
880,21,388,3137400,339,168,171
881,21,388,3137500,251,119,132
882,21,388,3137600,628,312,316
883,21,388,3137700,0,0,0
884,21,388,3137800,58,29,29
885,21,388,3137900,39,12,27
886,21,388,3138000,88,41,47
887,21,388,3138100,149,69,80
888,21,388,3138200,125,65,60
889,21,388,3138300,559,280,279
890,21,388,3138400,540,259,281
891,21,388,3138500,106,49,57
892,21,388,3138600,138,71,67
893,21,388,3138700,0,0,0
894,21,388,3138800,0,0,0
895,21,388,3138900,989,499,490
896,21,388,3139000,557,282,275
897,21,388,3139100,1352,694,658
898,21,388,3139200,638,316,322
899,21,388,3139300,0,0,0
900,21,388,3139400,478,231,247
901,21,388,3139500,0,0,0
902,21,388,3139600,954,482,472
903,21,388,3139700,641,326,315
904,21,388,3139800,229,115,114
905,21,388,3139900,420,225,195
906,21,388,3140000,2417,1259,1158
907,21,388,3140100,176,87,89
908,21,388,3140200,353,173,180
909,21,388,3140300,247,113,134
910,21,388,3140400,101,50,51
911,21,388,3140500,174,87,87
912,21,388,3140600,59,27,32
913,21,388,3140700,295,150,145
914,21,388,3140800,36,17,19
915,21,388,3140900,587,298,289
916,21,388,3141000,219,111,108
917,21,388,3141100,0,0,0
918,21,388,3141200,284,138,146
919,21,388,3141300,354,173,181
920,21,388,3141400,716,330,386
921,21,388,3141500,401,199,202
922,21,388,3141600,430,225,205
923,21,388,3141700,263,132,131
924,21,388,3141800,327,162,165
925,21,388,3141900,102,50,52
926,21,388,3142000,125,65,60
927,21,388,3142100,116,58,58
928,21,388,3142200,647,311,336
929,21,388,3142300,314,152,162
930,21,388,3142400,237,124,113
931,21,388,3142500,145,69,76
932,21,388,3142600,288,131,157
933,21,388,3142700,237,115,122
934,21,388,3142800,99,49,50
935,21,388,3142900,66,32,34
936,21,388,3143000,37,18,19
937,21,388,3143100,112,54,58
938,21,388,3143200,0,0,0
939,21,388,3143300,0,0,0
940,21,388,3143400,65,32,33
941,21,388,3143500,324,167,157
942,21,388,3143600,87,41,46
943,21,388,3143700,2022,1041,981
944,21,388,3143800,1393,693,700
945,21,388,3143900,1853,939,914
946,21,388,3144000,1036,518,518
947,21,388,3144100,105,49,56
948,21,388,3144200,1361,735,626
949,21,388,3144300,708,371,337
950,21,388,3144400,1740,911,829
951,21,388,3144500,542,265,277
952,21,388,3144600,487,240,247
953,21,388,3144700,4782,2391,2391
954,21,388,3144800,1585,778,807
955,21,388,3144900,542,252,290
956,21,388,3145000,0,0,0
957,21,388,3145100,186,97,89
958,21,388,3145200,70,37,33
959,21,388,3145300,0,0,0
960,21,388,3145400,1697,788,909
961,21,388,3145500,2,1,1
962,21,388,3145600,87,37,50
963,21,388,3145700,362,187,175
964,21,388,3145800,341,174,167
965,21,388,3145900,968,469,499
966,21,388,3146000,2242,1046,1196
967,21,388,3146100,19,6,13
968,21,388,3146200,1812,851,961
969,21,388,3146300,60,23,37
970,21,388,3146400,787,377,410
971,21,388,3146500,3694,1809,1885
972,21,388,3146600,1685,816,869
973,21,388,3146700,866,439,427
974,21,388,3146800,747,362,385
975,21,388,3146900,812,388,424
976,21,388,3147000,609,296,313
977,21,388,3147100,895,418,477
978,21,388,3147200,989,510,479
979,21,388,3147300,1448,693,755
980,21,388,3147400,760,375,385
981,21,388,3147500,1925,960,965
982,21,388,3147600,629,332,297
983,21,388,3147700,50,23,27
984,21,388,3147800,348,157,191
985,21,388,3147900,270,124,146
986,21,388,3148000,2256,1107,1149
987,21,388,3148100,273,131,142
988,21,388,3148200,3133,1476,1657
989,21,388,3148300,557,283,274
990,21,388,3148400,162,77,85
991,21,388,3148500,504,255,249
992,21,388,3148600,1130,549,581
993,21,388,3148700,358,166,192
994,21,388,3148800,49,23,26
995,21,388,3148900,1920,987,933
996,21,388,3149000,0,0,0
997,21,388,3149100,1338,693,645
998,21,388,3149200,1040,530,510
999,21,388,3149300,445,215,230
1000,21,388,3149400,468,240,228
1001,21,388,3149500,0,0,0
1002,21,388,3149600,250,130,120
1003,21,388,3149700,343,173,170
1004,21,388,3149800,2909,1464,1445
1005,21,388,3149900,99,52,47
1006,21,388,3150000,111,59,52
1007,21,388,3150100,0,0,0
1008,21,388,3150200,84,36,48
1009,21,388,3150300,315,161,154
1010,21,388,3150400,3624,1822,1802
1011,21,388,3150500,206,110,96
1012,21,388,3150600,961,477,484
1013,21,388,3150700,87,46,41
1014,21,388,3150800,350,175,175
1015,21,388,3150900,1410,731,679
1016,21,388,3151000,965,443,522
1017,21,388,3151100,43,21,22
1018,21,388,3151200,324,164,160
1019,21,388,3151300,577,317,260
1020,21,388,3151400,2468,1190,1278
1021,21,388,3151500,483,239,244
1022,21,388,3151600,343,177,166
1023,21,388,3151700,3383,1737,1646
1024,21,388,3151800,1215,634,581
1025,21,388,3151900,1255,640,615
1026,21,388,3152000,961,468,493
1027,21,388,3152100,540,247,293
1028,21,388,3152200,683,299,384
1029,21,388,3152300,3285,1697,1588
1030,21,388,3152400,1113,530,583
1031,21,388,3152500,643,288,355
1032,21,388,3152600,2635,1161,1474
1033,21,388,3152700,762,399,363
1034,21,388,3152800,558,281,277
1035,21,388,3152900,33,13,20
1036,21,388,3153000,580,295,285
1037,21,388,3153100,393,202,191
1038,21,388,3153200,1612,803,809
1039,21,388,3153300,0,0,0
1040,21,388,3153400,624,310,314
1041,21,388,3153500,672,334,338
1042,21,388,3153600,282,134,148
1043,21,388,3153700,1143,591,552
1044,21,388,3153800,433,225,208
1045,21,388,3153900,612,282,330
1046,21,388,3154000,785,402,383
1047,21,388,3154100,4684,2348,2336
1048,21,388,3154200,1618,810,808
1049,21,388,3154300,1449,764,685
1050,21,388,3154400,2597,1317,1280
1051,21,388,3154500,609,289,320
1052,21,388,3154600,987,492,495
1053,21,388,3154700,2122,1052,1070
1054,21,388,3154800,1259,649,610
1055,21,388,3154900,827,424,403
1056,21,388,3155000,2370,1186,1184
1057,21,388,3155100,1256,624,632
1058,21,388,3155200,653,339,314
1059,21,388,3155300,0,0,0
1060,21,388,3155400,0,0,0
1061,21,388,3155500,1224,587,637
1062,21,388,3155600,650,321,329
1063,21,388,3155700,264,122,142
1064,21,388,3155800,0,0,0
1065,21,388,3155900,470,242,228
1066,21,388,3156000,961,493,468
1067,21,388,3156100,979,454,525
1068,21,388,3156200,8,5,3
1069,21,388,3156300,0,0,0
1070,21,388,3156400,87,41,46
1071,21,388,3156500,1064,526,538
1072,21,388,3156600,1030,538,492
1073,21,388,3156700,0,0,0
1074,21,388,3156800,1842,950,892
1075,21,388,3156900,1683,859,824
1076,21,388,3157000,1164,579,585
1077,21,388,3157100,262,138,124
1078,21,388,3157200,0,0,0
1079,21,388,3157300,1826,952,874
1080,21,388,3157400,539,292,247
1081,21,388,3157500,0,0,0
1082,21,388,3157600,541,263,278
1083,21,388,3157700,2568,1299,1269
1084,21,388,3157800,1251,624,627
1085,21,388,3157900,770,373,397
1086,21,388,3158000,562,271,291
1087,21,388,3158100,69,33,36
1088,21,388,3158200,990,473,517
1089,21,388,3158300,1055,526,529
1090,21,388,3158400,1367,659,708
1091,21,388,3158500,2061,967,1094
1092,21,388,3158600,1210,577,633
1093,21,388,3158700,0,0,0
1094,21,388,3158800,24,14,10
1095,21,388,3158900,0,0,0
1096,21,388,3159000,1280,635,645
1097,21,388,3159100,576,303,273
1098,21,388,3159200,0,0,0
1099,21,388,3159300,1138,581,557
1100,21,388,3159400,611,322,289
1101,21,388,3159500,2123,1016,1107
1102,21,388,3159600,238,125,113
1103,21,388,3159700,381,196,185
1104,21,388,3159800,159,75,84
1105,21,388,3159900,496,251,245
1106,21,388,3160000,43,22,21
1107,21,388,3160100,0,0,0
1108,21,388,3160200,0,0,0
1109,21,388,3160300,0,0,0
1110,21,388,3160400,649,308,341
1111,21,388,3160500,1178,540,638
1112,21,388,3160600,665,331,334
1113,21,388,3160700,1297,619,678
1114,21,388,3160800,384,166,218
1115,21,388,3160900,2562,1324,1238
1116,21,388,3161000,0,0,0
1117,21,388,3161100,451,236,215
1118,21,388,3161200,1397,733,664
1119,21,388,3161300,362,185,177
1120,21,388,3161400,75,37,38
1121,21,388,3161500,0,0,0
1122,21,388,3161600,1377,693,684
1123,21,388,3161700,1143,555,588
1124,21,388,3161800,439,224,215
1125,21,388,3161900,2573,1216,1357
1126,21,388,3162000,4866,2369,2497
1127,21,388,3162100,872,438,434
1128,21,388,3162200,1524,724,800
1129,21,388,3162300,958,485,473
1130,21,388,3162400,0,0,0
1131,21,388,3162500,1005,501,504
1132,21,388,3162600,1122,555,567
1133,21,388,3162700,497,226,271
1134,21,388,3162800,175,87,88
1135,21,388,3162900,1267,643,624
1136,21,388,3163000,324,154,170
1137,21,388,3163100,131,68,63
1138,21,388,3163200,170,79,91
1139,21,388,3163300,404,191,213
1140,21,388,3163400,2001,1004,997
1141,21,388,3163500,374,174,200
1142,21,388,3163600,520,263,257
1143,21,388,3163700,566,290,276
1144,21,388,3163800,351,173,178
1145,21,388,3163900,411,204,207
1146,21,388,3164000,1132,554,578
1147,21,388,3164100,64,26,38
1148,21,388,3164200,812,373,439
1149,21,388,3164300,56,27,29
1150,21,388,3164400,674,316,358
1151,21,388,3164500,1081,573,508
1152,21,388,3164600,486,266,220
1153,21,388,3164700,330,168,162
1154,21,388,3164800,0,0,0
1155,21,388,3164900,417,218,199
1156,21,388,3165000,624,323,301
1157,21,388,3165100,1295,666,629
1158,21,388,3165200,1074,543,531
1159,21,388,3165300,71,32,39
1160,21,388,3165400,306,159,147
1161,21,388,3165500,1297,694,603
1162,21,388,3165600,0,0,0
1163,21,388,3165700,292,152,140
1164,21,388,3165800,249,131,118
1165,21,388,3165900,578,295,283
1166,21,388,3166000,247,118,129
1167,21,388,3166100,208,105,103
1168,21,388,3166200,1169,588,581
1169,21,388,3166300,855,419,436
1170,21,388,3166400,421,193,228
1171,21,388,3166500,0,0,0
1172,21,388,3166600,2172,1043,1129
1173,21,388,3166700,1130,566,564
1174,21,388,3166800,1386,693,693
1175,21,388,3166900,1592,804,788
1176,21,388,3167000,1066,516,550
1177,21,388,3167100,1366,673,693
1178,21,388,3167200,1915,942,973
1179,21,388,3167300,2231,1126,1105
1180,21,388,3167400,964,443,521
1181,21,388,3167500,2802,1364,1438
1182,21,388,3167600,282,140,142
1183,21,388,3167700,213,113,100
1184,21,388,3167800,2909,1428,1481
1185,21,388,3167900,2162,1070,1092
1186,21,388,3168000,1007,490,517
1187,21,388,3168100,2807,1382,1425
1188,21,388,3168200,2921,1439,1482
1189,21,388,3168300,437,217,220
1190,21,388,3168400,3370,1761,1609
1191,21,388,3168500,610,286,324
1192,21,388,3168600,1023,496,527
1193,21,388,3168700,3,1,2
1194,21,388,3168800,750,351,399
1195,21,388,3168900,587,296,291
1196,21,388,3169000,469,231,238
1197,21,388,3169100,1544,764,780
1198,21,388,3169200,953,496,457
1199,21,388,3169300,1100,537,563
1200,21,388,3169400,752,352,400
1201,21,388,3169500,591,304,287
1202,21,388,3169600,2501,1242,1259
1203,21,388,3169700,0,0,0
1204,21,388,3169800,1526,756,770
1205,21,388,3169900,1397,699,698
1206,21,388,3170000,1166,561,605
1207,21,388,3170100,1334,637,697
1208,21,388,3170200,2000,983,1017
1209,21,388,3170300,904,455,449
1210,21,388,3170400,370,167,203
1211,21,388,3170500,647,292,355
1212,21,388,3170600,265,112,153
1213,21,388,3170700,1746,905,841
1214,21,388,3170800,757,350,407
1215,21,388,3170900,5947,2965,2982
1216,21,388,3171000,1838,943,895
1217,21,388,3171100,2661,1320,1341
1218,21,388,3171200,3626,1762,1864
1219,21,388,3171300,1225,546,679
1220,21,388,3171400,457,218,239
1221,21,388,3171500,3013,1474,1539
1222,21,388,3171600,401,180,221
1223,21,388,3171700,0,0,0
1224,21,388,3171800,0,0,0
1225,21,388,3171900,785,364,421
1226,21,388,3172000,1867,885,982
1227,21,388,3172100,834,423,411
1228,21,388,3172200,381,193,188
1229,21,388,3172300,2280,1161,1119
1230,21,388,3172400,428,218,210
1231,21,388,3172500,10,4,6
1232,21,388,3172600,1072,540,532
1233,21,388,3172700,7,3,4
1234,21,388,3172800,1811,937,874
1235,21,388,3172900,753,356,397
1236,21,388,3173000,0,0,0
1237,21,388,3173100,25,14,11
1238,21,388,3173200,1210,562,648
1239,21,388,3173300,582,293,289
1240,21,388,3173400,1205,600,605
1241,21,388,3173500,1772,816,956
1242,21,388,3173600,1467,756,711
1243,21,388,3173700,1437,687,750
1244,21,388,3173800,2129,1031,1098
1245,21,388,3173900,1036,525,511
1246,21,388,3174000,1145,590,555
1247,21,388,3174100,645,330,315
1248,21,388,3174200,651,330,321
1249,21,388,3174300,1828,866,962
1250,21,388,3174400,907,479,428
1251,21,388,3174500,449,216,233
1252,21,388,3174600,668,336,332
1253,21,388,3174700,4699,2206,2493
1254,21,388,3174800,856,417,439
1255,21,388,3174900,849,376,473
1256,21,388,3175000,2338,1155,1183
1257,21,388,3175100,1833,855,978
1258,21,388,3175200,780,387,393
1259,21,388,3175300,944,467,477
1260,21,388,3175400,0,0,0
1261,21,388,3175500,836,377,459
1262,21,388,3175600,1109,524,585
1263,21,388,3175700,0,0,0
1264,21,388,3175800,0,0,0
1265,21,388,3175900,0,0,0
1266,21,388,3176000,395,207,188
1267,21,388,3176100,231,112,119
1268,21,388,3176200,33,12,21
1269,21,388,3176300,193,96,97
1270,21,388,3176400,0,0,0
1271,21,388,3176500,1511,787,724
1272,21,388,3176600,1422,695,727
1273,21,388,3176700,0,0,0
1274,21,388,3176800,4943,2327,2616
1275,21,388,3176900,1010,475,535
1276,21,388,3177000,1391,643,748
1277,21,388,3177100,805,396,409
1278,21,388,3177200,1643,764,879
1279,21,388,3177300,790,418,372
1280,21,388,3177400,993,509,484
1281,21,388,3177500,1768,917,851
1282,21,388,3177600,1730,841,889
1283,21,388,3177700,347,173,174
1284,21,388,3177800,1163,618,545
1285,21,388,3177900,4944,2508,2436
1286,21,388,3178000,217,105,112
1287,21,388,3178100,276,145,131
1288,21,388,3178200,824,440,384
1289,21,388,3178300,1619,789,830
1290,21,388,3178400,903,455,448
1291,21,388,3178500,625,330,295
1292,21,388,3178600,1380,698,682
1293,21,388,3178700,1078,548,530
1294,21,388,3178800,1157,568,589
1295,21,388,3178900,1158,589,569
1296,21,388,3179000,688,361,327
1297,21,388,3179100,1053,481,572
1298,21,388,3179200,1291,610,681
1299,21,388,3179300,1114,540,574
1300,21,388,3179400,2143,1112,1031
1301,21,388,3179500,954,462,492
1302,21,388,3179600,2111,1003,1108
1303,21,388,3179700,1359,671,688
1304,21,388,3179800,512,231,281
1305,21,388,3179900,337,161,176
1306,21,388,3180000,2079,1014,1065
1307,21,388,3180100,700,330,370
1308,21,388,3180200,1768,933,835
1309,21,388,3180300,180,88,92
1310,21,388,3180400,4142,2036,2106
1311,21,388,3180500,910,475,435
1312,21,388,3180600,1113,547,566
1313,21,388,3180700,542,273,269
1314,21,388,3180800,1879,954,925
1315,21,388,3180900,0,0,0
1316,21,388,3181000,0,0,0
1317,21,388,3181100,0,0,0
1318,21,388,3181200,0,0,0
1319,21,388,3181300,0,0,0
1320,21,388,3181400,1439,674,765
1321,21,388,3181500,362,165,197
1322,21,388,3181600,1882,859,1023
1323,21,388,3181700,1059,524,535
1324,21,388,3181800,542,261,281
1325,21,388,3181900,255,130,125
1326,21,388,3182000,4753,2419,2334
1327,21,388,3182100,618,300,318
1328,21,388,3182200,986,478,508
1329,21,388,3182300,1367,669,698
1330,21,388,3182400,531,257,274
1331,21,388,3182500,1551,764,787
1332,21,388,3182600,2291,1180,1111
1333,21,388,3182700,671,315,356
1334,21,388,3182800,785,385,400
1335,21,388,3182900,999,448,551
1336,21,388,3183000,438,230,208
1337,21,388,3183100,578,249,329
1338,21,388,3183200,816,385,431
1339,21,388,3183300,385,178,207
1340,21,388,3183400,746,368,378
1341,21,388,3183500,2293,1120,1173
1342,21,388,3183600,2092,1043,1049
1343,21,388,3183700,2100,1024,1076
1344,21,388,3183800,897,443,454
1345,21,388,3183900,571,277,294
1346,21,388,3184000,687,328,359
1347,21,388,3184100,1898,887,1011
1348,21,388,3184200,893,422,471
1349,21,388,3184300,1398,711,687
1350,21,388,3184400,1507,749,758
1351,21,388,3184500,283,156,127
1352,21,388,3184600,1636,794,842
1353,21,388,3184700,1505,783,722
1354,21,388,3184800,541,282,259
1355,21,388,3184900,700,339,361
1356,21,388,3185000,555,272,283
1357,21,388,3185100,2020,993,1027
1358,21,388,3185200,418,208,210
1359,21,388,3185300,505,255,250
1360,21,388,3185400,0,0,0
1361,21,388,3185500,808,406,402
1362,21,388,3185600,4988,2427,2561
1363,21,388,3185700,2160,1044,1116
1364,21,388,3185800,101,48,53
1365,21,388,3185900,106,56,50
1366,21,388,3186000,143,71,72
1367,21,388,3186100,18,10,8
1368,21,388,3186200,187,88,99
1369,21,388,3186300,87,50,37
1370,21,388,3186400,210,106,104
1371,21,388,3186500,333,177,156
1372,21,388,3186600,567,298,269
1373,21,388,3186700,143,74,69
1374,21,388,3186800,45,21,24
1375,21,388,3186900,6,3,3
1376,21,388,3187000,676,342,334
1377,21,388,3187100,81,40,41
1378,21,388,3187200,1746,887,859
1379,21,388,3187300,831,388,443
1380,21,388,3187400,71,33,38
1381,21,388,3187500,146,69,77
1382,21,388,3187600,68,34,34
1383,21,388,3187700,938,452,486
1384,21,388,3187800,74,37,37
1385,21,388,3187900,0,0,0
1386,21,388,3188000,158,75,83
1387,21,388,3188100,106,56,50
1388,21,388,3188200,96,52,44
1389,21,388,3188300,187,106,81
1390,21,388,3188400,14,7,7
1391,21,388,3188500,34,17,17
1392,21,388,3188600,24,9,15
1393,21,388,3188700,282,144,138
1394,21,388,3188800,68,34,34
1395,21,388,3188900,74,42,32
1396,21,388,3189000,77,41,36
1397,21,388,3189100,44,25,19
1398,21,388,3189200,84,37,47
1399,21,388,3189300,859,439,420
1400,21,388,3189400,974,482,492
1401,21,388,3189500,0,0,0
1402,21,388,3189600,85,41,44
1403,21,388,3189700,0,0,0
1404,21,388,3189800,0,0,0
1405,21,388,3189900,2374,1185,1189
1406,21,388,3190000,0,0,0
1407,21,388,3190100,25,13,12
1408,21,388,3190200,16,7,9
1409,21,388,3190300,580,282,298
1410,21,388,3190400,0,0,0
1411,21,388,3190500,314,148,166
1412,21,388,3190600,44,22,22
1413,21,388,3190700,107,59,48
1414,21,388,3190800,1308,628,680
1415,21,388,3190900,1364,651,713
1416,21,388,3191000,562,248,314
1417,21,388,3191100,1585,740,845
1418,21,388,3191200,146,78,68
1419,21,388,3191300,20,9,11
1420,21,388,3191400,455,212,243
1421,21,388,3191500,130,62,68
1422,21,388,3191600,20,7,13
1423,21,388,3191700,87,42,45
1424,21,388,3191800,100,52,48
1425,21,388,3191900,93,43,50
1426,21,388,3192000,43,25,18
1427,21,388,3192100,6,3,3
1428,21,388,3192200,0,0,0
1429,21,388,3192300,0,0,0
1430,21,388,3192400,162,83,79
1431,21,388,3192500,49,23,26
1432,21,388,3192600,115,60,55
1433,21,388,3192700,149,72,77
1434,21,388,3192800,106,51,55
1435,21,388,3192900,118,60,58
1436,21,388,3193000,48,30,18
1437,21,388,3193100,0,0,0
1438,21,388,3193200,33,10,23
1439,21,388,3193300,22,12,10
1440,21,388,3193400,25,15,10
1441,21,388,3193500,46,21,25
1442,21,388,3193600,76,37,39
1443,21,388,3193700,52,26,26
1444,21,388,3193800,712,354,358
1445,21,388,3193900,2167,1028,1139
1446,21,388,3194000,293,143,150
1447,21,388,3194100,2326,1106,1220
1448,21,388,3194200,2931,1456,1475
1449,21,388,3194300,809,401,408
1450,21,388,3194400,1917,960,957
1451,21,388,3194500,571,279,292
1452,21,388,3194600,1006,492,514
1453,21,388,3194700,1199,558,641
1454,21,388,3194800,448,206,242
1455,21,388,3194900,1611,779,832
1456,21,388,3195000,111,54,57
1457,21,388,3195100,45,23,22
1458,21,388,3195200,3,0,3
1459,21,388,3195300,0,0,0
1460,21,388,3195400,636,291,345
1461,21,388,3195500,0,0,0
1462,21,388,3195600,0,0,0
1463,21,388,3195700,0,0,0
1464,21,388,3195800,37,17,20
1465,21,388,3195900,419,223,196
1466,21,388,3196000,260,142,118
1467,21,388,3196100,413,218,195
1468,21,388,3196200,29,14,15
1469,21,388,3196300,533,262,271
1470,21,388,3196400,2093,1026,1067
1471,21,388,3196500,815,402,413
1472,21,388,3196600,76,35,41
1473,21,388,3196700,144,81,63
1474,21,388,3196800,0,0,0
1475,21,388,3196900,206,94,112
1476,21,388,3197000,0,0,0
1477,21,388,3197100,785,402,383
1478,21,388,3197200,1880,943,937
1479,21,388,3197300,0,0,0
1480,21,388,3197400,287,137,150
1481,21,388,3197500,899,435,464
1482,21,388,3197600,0,0,0
1483,21,388,3197700,1449,702,747
1484,21,388,3197800,1420,689,731
1485,21,388,3197900,356,197,159
1486,21,388,3198000,238,119,119
1487,21,388,3198100,0,0,0
1488,21,388,3198200,0,0,0
1489,21,388,3198300,350,174,176
1490,21,388,3198400,0,0,0
1491,21,388,3198500,1612,780,832
1492,21,388,3198600,1698,848,850
1493,21,388,3198700,450,226,224
1494,21,388,3198800,824,374,450
1495,21,388,3198900,606,285,321
1496,21,388,3199000,445,231,214
1497,21,388,3199100,218,113,105
1498,21,388,3199200,923,429,494
1499,21,388,3199300,0,0,0
1500,21,388,3199400,0,0,0
1501,21,388,3199500,0,0,0
1502,21,388,3199600,0,0,0
1503,21,388,3199700,258,131,127
1504,21,388,3199800,103,50,53
1505,21,388,3199900,19,11,8
1506,21,388,3200000,38,19,19
1507,21,388,3200100,112,54,58
1508,21,388,3200200,758,393,365
1509,21,388,3200300,1530,756,774
1510,21,388,3200400,1711,805,906
1511,21,388,3200500,446,218,228
1512,21,388,3200600,470,231,239
1513,21,388,3200700,851,443,408
1514,21,388,3200800,2141,1101,1040
1515,21,388,3200900,1305,613,692
1516,21,388,3201000,160,74,86
1517,21,388,3201100,0,0,0
1518,21,388,3201200,3332,1752,1580
1519,21,388,3201300,880,427,453
1520,21,388,3201400,306,159,147
1521,21,388,3201500,2815,1461,1354
1522,21,388,3201600,1477,765,712
1523,21,388,3201700,1879,972,907
1524,21,388,3201800,1484,746,738
1525,21,388,3201900,1305,630,675
1526,21,388,3202000,195,93,102
1527,21,388,3202100,94,48,46
1528,21,388,3202200,14,7,7
1529,21,388,3202300,0,0,0
1530,21,388,3202400,0,0,0
1531,21,388,3202500,0,0,0
1532,21,388,3202600,41,22,19
1533,21,388,3202700,2217,1026,1191
1534,21,388,3202800,21,12,9
1535,21,388,3202900,492,245,247
1536,21,388,3203000,953,447,506
1537,21,388,3203100,0,0,0
1538,21,388,3203200,0,0,0
1539,21,388,3203300,0,0,0
1540,21,388,3203400,0,0,0
1541,21,388,3203500,0,0,0
1542,21,388,3203600,0,0,0
1543,21,388,3203700,0,0,0
1544,21,388,3203800,0,0,0
1545,21,388,3203900,720,372,348
1546,21,388,3204000,1311,659,652
1547,21,388,3204100,747,386,361
1548,21,388,3204200,318,153,165
1549,21,388,3204300,227,118,109
1550,21,388,3204400,1476,712,764
1551,21,388,3204500,0,0,0
1552,21,388,3204600,84,37,47
1553,21,388,3204700,0,0,0
1554,21,388,3204800,0,0,0
1555,21,388,3204900,0,0,0
1556,21,388,3205000,137,68,69
1557,21,388,3205100,126,59,67
1558,21,388,3205200,61,30,31
1559,21,388,3205300,34,20,14
1560,21,388,3205400,262,139,123
1561,21,388,3205500,121,61,60
1562,21,388,3205600,0,0,0
1563,21,388,3205700,5995,2879,3116
1564,21,388,3205800,883,434,449
1565,21,388,3205900,480,224,256
1566,21,388,3206000,896,433,463
1567,21,388,3206100,0,0,0
1568,21,388,3206200,1496,762,734
1569,21,388,3206300,0,0,0
1570,21,388,3206400,381,195,186
1571,21,388,3206500,566,262,304
1572,21,388,3206600,0,0,0
1573,21,388,3206700,1355,697,658
1574,21,388,3206800,2610,1364,1246
1575,21,388,3206900,0,0,0
1576,21,388,3207000,949,528,421
1577,21,388,3207100,2594,1208,1386
1578,21,388,3207200,0,0,0
1579,21,388,3207300,945,432,513
1580,21,388,3207400,574,277,297
1581,21,388,3207500,1585,802,783
1582,21,388,3207600,68,34,34
1583,21,388,3207700,639,336,303
1584,21,388,3207800,1317,631,686
1585,21,388,3207900,551,247,304
1586,21,388,3208000,676,328,348
1587,21,388,3208100,1765,878,887
1588,21,388,3208200,0,0,0
1589,21,388,3208300,1386,664,722
1590,21,388,3208400,1250,604,646
1591,21,388,3208500,909,437,472
1592,21,388,3208600,382,194,188
1593,21,388,3208700,360,181,179
1594,21,388,3208800,178,87,91
1595,21,388,3208900,846,363,483
1596,21,388,3209000,1637,748,889
1597,21,388,3209100,231,117,114
1598,21,388,3209200,19,10,9
1599,21,388,3209300,564,287,277
1600,21,388,3209400,489,258,231
1601,21,388,3209500,51,24,27
1602,21,388,3209600,1245,618,627
1603,21,388,3209700,2308,1163,1145
1604,21,388,3209800,0,0,0
1605,21,388,3209900,0,0,0
1606,21,388,3210000,1187,590,597
1607,21,388,3210100,1111,580,531
1608,21,388,3210200,1179,559,620
1609,21,388,3210300,1078,518,560
1610,21,388,3210400,1186,599,587
1611,21,388,3210500,1418,654,764
1612,21,388,3210600,274,129,145
1613,21,388,3210700,490,259,231
1614,21,388,3210800,592,279,313
1615,21,388,3210900,842,372,470
1616,21,388,3211000,508,221,287
1617,21,388,3211100,0,0,0
1618,21,388,3211200,448,210,238
1619,21,388,3211300,3527,1661,1866
1620,21,388,3211400,1975,948,1027
1621,21,388,3211500,387,166,221
1622,21,388,3211600,1365,674,691
1623,21,388,3211700,113,57,56
1624,21,388,3211800,831,389,442
1625,21,388,3211900,473,243,230
1626,21,388,3212000,0,0,0
1627,21,388,3212100,921,449,472
1628,21,388,3212200,0,0,0
1629,21,388,3212300,904,454,450
1630,21,388,3212400,674,335,339
1631,21,388,3212500,63,33,30
1632,21,388,3212600,374,175,199
1633,21,388,3212700,0,0,0
1634,21,388,3212800,424,212,212
1635,21,388,3212900,18,11,7
1636,21,388,3213000,185,92,93
1637,21,388,3213100,279,124,155
1638,21,388,3213200,143,63,80
1639,21,388,3213300,181,87,94
1640,21,388,3213400,86,40,46
1641,21,388,3213500,0,0,0
1642,21,388,3213600,330,166,164
1643,21,388,3213700,520,254,266
1644,21,388,3213800,188,100,88
1645,21,388,3213900,261,142,119
1646,21,388,3214000,167,79,88
1647,21,388,3214100,63,27,36
1648,21,388,3214200,175,87,88
1649,21,388,3214300,3086,1562,1524
1650,21,388,3214400,253,126,127
1651,21,388,3214500,49,24,25
1652,21,388,3214600,259,142,117
1653,21,388,3214700,0,0,0
1654,21,388,3214800,0,0,0
1655,21,388,3214900,0,0,0
1656,21,388,3215000,63,31,32
1657,21,388,3215100,194,94,100
1658,21,388,3215200,0,0,0
1659,21,388,3215300,0,0,0
1660,21,388,3215400,0,0,0
1661,21,388,3215500,76,38,38
1662,21,388,3215600,0,0,0
1663,21,388,3215700,589,294,295
1664,21,388,3215800,716,365,351
1665,21,388,3215900,854,420,434
1666,21,388,3216000,311,147,164
1667,21,388,3216100,0,0,0
1668,21,388,3216200,0,0,0
1669,21,388,3216300,0,0,0
1670,21,388,3216400,0,0,0
1671,21,388,3216500,0,0,0
1672,21,388,3216600,227,107,120
1673,21,388,3216700,2301,1127,1174
1674,21,388,3216800,0,0,0
1675,21,388,3216900,2479,1155,1324
1676,21,388,3217000,1685,807,878
1677,21,388,3217100,1012,479,533
1678,21,388,3217200,625,335,290
1679,21,388,3217300,723,346,377
1680,21,388,3217400,13,8,5
1681,21,388,3217500,1190,574,616
1682,21,388,3217600,319,154,165
1683,21,388,3217700,93,37,56
1684,21,388,3217800,0,0,0
1685,21,388,3217900,1239,609,630
1686,21,388,3218000,135,63,72
1687,21,388,3218100,768,381,387
1688,21,388,3218200,1229,601,628
1689,21,388,3218300,0,0,0
1690,21,388,3218400,0,0,0
1691,21,388,3218500,0,0,0
1692,21,388,3218600,274,134,140
1693,21,388,3218700,68,36,32
1694,21,388,3218800,1471,748,723
1695,21,388,3218900,1184,592,592
1696,21,388,3219000,324,153,171
1697,21,388,3219100,181,80,101
1698,21,388,3219200,381,176,205
1699,21,388,3219300,1045,499,546
1700,21,388,3219400,223,100,123
1701,21,388,3219500,0,0,0
1702,21,388,3219600,3405,1673,1732
1703,21,388,3219700,1452,696,756
1704,21,388,3219800,746,362,384
1705,21,388,3219900,945,467,478
1706,21,388,3220000,446,200,246
1707,21,388,3220100,0,0,0
1708,21,388,3220200,0,0,0
1709,21,388,3220300,130,62,68
1710,21,388,3220400,671,311,360
1711,21,388,3220500,747,387,360
1712,21,388,3220600,0,0,0
1713,21,388,3220700,0,0,0
1714,21,388,3220800,59,34,25
1715,21,388,3220900,1077,551,526
1716,21,388,3221000,274,140,134
1717,21,388,3221100,0,0,0
1718,21,388,3221200,0,0,0
1719,21,388,3221300,0,0,0
1720,21,388,3221400,113,49,64
1721,21,388,3221500,0,0,0
1722,21,388,3221600,279,156,123
1723,21,388,3221700,424,200,224
1724,21,388,3221800,679,330,349
1725,21,388,3221900,469,249,220
1726,21,388,3222000,800,418,382
1727,21,388,3222100,532,271,261
1728,21,388,3222200,95,51,44
1729,21,388,3222300,181,97,84
1730,21,388,3222400,80,41,39
1731,21,388,3222500,2973,1509,1464
1732,21,388,3222600,82,48,34
1733,21,388,3222700,449,207,242
1734,21,388,3222800,199,101,98
1735,21,388,3222900,802,390,412
1736,21,388,3223000,755,392,363
1737,21,388,3223100,248,129,119
1738,21,388,3223200,1791,933,858
1739,21,388,3223300,1035,537,498
1740,21,388,3223400,906,462,444
1741,21,388,3223500,805,431,374
1742,21,388,3223600,542,272,270
1743,21,388,3223700,15,12,3
1744,21,388,3223800,4478,2283,2195
1745,21,388,3223900,1083,543,540
1746,21,388,3224000,597,315,282
1747,21,388,3224100,0,0,0
1748,21,388,3224200,483,245,238
1749,21,388,3224300,0,0,0
1750,21,388,3224400,4429,2248,2181
1751,21,388,3224500,0,0,0
1752,21,388,3224600,24,10,14
1753,21,388,3224700,261,121,140
1754,21,388,3224800,75,34,41
1755,21,388,3224900,0,0,0
1756,21,388,3225000,24,7,17
1757,21,388,3225100,0,0,0
1758,21,388,3225200,0,0,0
1759,21,388,3225300,0,0,0
1760,21,388,3225400,159,84,75
1761,21,388,3225500,407,213,194
1762,21,388,3225600,1030,527,503
1763,21,388,3225700,475,231,244
1764,21,388,3225800,896,417,479
1765,21,388,3225900,2186,1056,1130
1766,21,388,3226000,113,49,64
1767,21,388,3226100,5,3,2
1768,21,388,3226200,1249,627,622
1769,21,388,3226300,1795,932,863
1770,21,388,3226400,986,445,541
1771,21,388,3226500,1234,629,605
1772,21,388,3226600,0,0,0
1773,21,388,3226700,1349,638,711
1774,21,388,3226800,1094,533,561
1775,21,388,3226900,261,126,135
1776,21,388,3227000,0,0,0
1777,21,388,3227100,1901,918,983
1778,21,388,3227200,1263,625,638
1779,21,388,3227300,2020,1076,944
1780,21,388,3227400,1896,943,953
1781,21,388,3227500,574,304,270
1782,21,388,3227600,227,115,112
1783,21,388,3227700,0,0,0
1784,21,388,3227800,128,62,66
1785,21,388,3227900,0,0,0
1786,21,388,3228000,521,264,257
1787,21,388,3228100,0,0,0
1788,21,388,3228200,131,68,63
1789,21,388,3228300,42,21,21
1790,21,388,3228400,0,0,0
1791,21,388,3228500,0,0,0
1792,21,388,3228600,0,0,0
1793,21,388,3228700,452,214,238
1794,21,388,3228800,182,86,96
1795,21,388,3228900,674,315,359
1796,21,388,3229000,0,0,0
1797,21,388,3229100,142,73,69
1798,21,388,3229200,0,0,0
1799,21,388,3229300,674,345,329
1800,21,388,3229400,0,0,0
1801,21,388,3229500,663,343,320
1802,21,388,3229600,42,16,26
1803,21,388,3229700,87,43,44
1804,21,388,3229800,0,0,0
1805,21,388,3229900,1104,566,538
1806,21,388,3230000,58,29,29
1807,21,388,3230100,1153,573,580
1808,21,388,3230200,190,92,98
1809,21,388,3230300,160,79,81
1810,21,388,3230400,18,10,8
1811,21,388,3230500,0,0,0
1812,21,388,3230600,0,0,0
1813,21,388,3230700,556,271,285
1814,21,388,3230800,0,0,0
1815,21,388,3230900,0,0,0
1816,21,388,3231000,331,164,167
1817,21,388,3231100,522,243,279
1818,21,388,3231200,170,81,89
1819,21,388,3231300,0,0,0
1820,21,388,3231400,234,125,109
1821,21,388,3231500,127,62,65
1822,21,388,3231600,418,198,220
1823,21,388,3231700,643,314,329
1824,21,388,3231800,5114,2600,2514
1825,21,388,3231900,169,66,103
1826,21,388,3232000,1234,631,603
1827,21,388,3232100,194,94,100
1828,21,388,3232200,236,116,120
1829,21,388,3232300,0,0,0
1830,21,388,3232400,476,237,239
1831,21,388,3232500,0,0,0
1832,21,388,3232600,112,53,59
1833,21,388,3232700,310,154,156
1834,21,388,3232800,11,4,7
1835,21,388,3232900,468,238,230
1836,21,388,3233000,558,290,268
1837,21,388,3233100,359,181,178
1838,21,388,3233200,1144,533,611
1839,21,388,3233300,0,0,0
1840,21,388,3233400,2189,1086,1103
1841,21,388,3233500,887,449,438
1842,21,388,3233600,464,240,224
1843,21,388,3233700,934,490,444
1844,21,388,3233800,575,295,280
1845,21,388,3233900,0,0,0
1846,21,388,3234000,272,145,127
1847,21,388,3234100,624,339,285
1848,21,388,3234200,0,0,0
1849,21,388,3234300,634,310,324
1850,21,388,3234400,0,0,0
1851,21,388,3234500,229,119,110
1852,21,388,3234600,0,0,0
1853,21,388,3234700,0,0,0
1854,21,388,3234800,0,0,0
1855,21,388,3234900,0,0,0
1856,21,388,3235000,0,0,0
1857,21,388,3235100,1983,1009,974
1858,21,388,3235200,0,0,0
1859,21,388,3235300,1066,542,524
1860,21,388,3235400,231,117,114
1861,21,388,3235500,399,202,197
1862,21,388,3235600,0,0,0
1863,21,388,3235700,0,0,0
1864,21,388,3235800,0,0,0
1865,21,388,3235900,934,460,474
1866,21,388,3236000,168,89,79
1867,21,388,3236100,1752,856,896
1868,21,388,3236200,156,78,78
1869,21,388,3236300,567,305,262
1870,21,388,3236400,1025,513,512
1871,21,388,3236500,199,91,108
1872,21,388,3236600,541,260,281
1873,21,388,3236700,393,202,191
1874,21,388,3236800,367,193,174
1875,21,388,3236900,1780,909,871
1876,21,388,3237000,1012,523,489
1877,21,388,3237100,763,370,393
1878,21,388,3237200,803,401,402
1879,21,388,3237300,243,121,122
1880,21,388,3237400,75,34,41
1881,21,388,3237500,405,209,196
1882,21,388,3237600,322,152,170
1883,21,388,3237700,959,499,460
1884,21,388,3237800,988,500,488
1885,21,388,3237900,0,0,0
1886,21,388,3238000,0,0,0
1887,21,388,3238100,438,240,198
1888,21,388,3238200,197,105,92
1889,21,388,3238300,0,0,0
1890,21,388,3238400,267,137,130
1891,21,388,3238500,549,293,256
1892,21,388,3238600,196,103,93
1893,21,388,3238700,356,175,181
1894,21,388,3238800,0,0,0
1895,21,388,3238900,1045,542,503
1896,21,388,3239000,0,0,0
1897,21,388,3239100,711,388,323
1898,21,388,3239200,313,144,169
1899,21,388,3239300,744,395,349
1900,21,388,3239400,320,160,160
1901,21,388,3239500,0,0,0
1902,21,388,3239600,0,0,0
1903,21,388,3239700,105,56,49
1904,21,388,3239800,1299,655,644
1905,21,388,3239900,62,27,35
1906,21,388,3240000,3707,1894,1813
1907,21,388,3240100,247,117,130
1908,21,388,3240200,214,120,94
1909,21,388,3240300,293,149,144
1910,21,388,3240400,1127,602,525
1911,21,388,3240500,215,115,100
1912,21,388,3240600,505,257,248
1913,21,388,3240700,918,479,439
1914,21,388,3240800,284,132,152
1915,21,388,3240900,1152,651,501
1916,21,388,3241000,683,364,319
1917,21,388,3241100,4386,2261,2125
1918,21,388,3241200,1375,693,682
1919,21,388,3241300,0,0,0
1920,21,388,3241400,646,332,314
1921,21,388,3241500,325,148,177
1922,21,388,3241600,0,0,0
1923,21,388,3241700,597,299,298
1924,21,388,3241800,0,0,0
1925,21,388,3241900,899,437,462
1926,21,388,3242000,1369,721,648
1927,21,388,3242100,2117,1077,1040
1928,21,388,3242200,0,0,0
1929,21,388,3242300,452,214,238
1930,21,388,3242400,0,0,0
1931,21,388,3242500,1355,705,650
1932,21,388,3242600,4740,2454,2286
1933,21,388,3242700,220,117,103
1934,21,388,3242800,1309,620,689
1935,21,388,3242900,1848,953,895
1936,21,388,3243000,795,395,400
1937,21,388,3243100,1367,707,660
1938,21,388,3243200,794,409,385
1939,21,388,3243300,1142,551,591
1940,21,388,3243400,1269,654,615
1941,21,388,3243500,496,256,240
1942,21,388,3243600,0,0,0
1943,21,388,3243700,580,299,281
1944,21,388,3243800,468,225,243
1945,21,388,3243900,1241,577,664
1946,21,388,3244000,491,258,233
1947,21,388,3244100,268,141,127
1948,21,388,3244200,549,283,266
1949,21,388,3244300,788,373,415
1950,21,388,3244400,1160,585,575
1951,21,388,3244500,2899,1370,1529
1952,21,388,3244600,975,487,488
1953,21,388,3244700,522,269,253
1954,21,388,3244800,1240,646,594
1955,21,388,3244900,325,174,151
1956,21,388,3245000,459,241,218
1957,21,388,3245100,185,102,83
1958,21,388,3245200,785,405,380
1959,21,388,3245300,6552,3244,3308
1960,21,388,3245400,1128,579,549
1961,21,388,3245500,370,179,191
1962,21,388,3245600,2519,1217,1302
1963,21,388,3245700,487,237,250
1964,21,388,3245800,1848,922,926
1965,21,388,3245900,0,0,0
1966,21,388,3246000,301,152,149
1967,21,388,3246100,2642,1345,1297
1968,21,388,3246200,136,72,64
1969,21,388,3246300,0,0,0
1970,21,388,3246400,1952,984,968
1971,21,388,3246500,944,482,462
1972,21,388,3246600,2636,1357,1279
1973,21,388,3246700,3068,1567,1501
1974,21,388,3246800,1433,737,696
1975,21,388,3246900,931,468,463
1976,21,388,3247000,337,153,184
1977,21,388,3247100,918,458,460
1978,21,388,3247200,2489,1245,1244
1979,21,388,3247300,52,31,21
1980,21,388,3247400,161,82,79
1981,21,388,3247500,2198,1056,1142
1982,21,388,3247600,0,0,0
1983,21,388,3247700,173,85,88
1984,21,388,3247800,1627,782,845
1985,21,388,3247900,1083,530,553
1986,21,388,3248000,5401,2723,2678
1987,21,388,3248100,332,166,166
1988,21,388,3248200,2117,1083,1034
1989,21,388,3248300,936,478,458
1990,21,388,3248400,577,305,272
1991,21,388,3248500,369,204,165
1992,21,388,3248600,2495,1218,1277
1993,21,388,3248700,376,183,193
1994,21,388,3248800,1734,874,860
1995,21,388,3248900,1297,630,667
1996,21,388,3249000,1669,855,814
1997,21,388,3249100,795,410,385
1998,21,388,3249200,1575,800,775
1999,21,388,3249300,0,0,0
2000,21,388,3249400,691,363,328
2001,21,388,3249500,1030,517,513
2002,21,388,3249600,1217,622,595
2003,21,388,3249700,296,161,135
2004,21,388,3249800,667,331,336
2005,21,388,3249900,396,216,180
2006,21,388,3250000,108,52,56
2007,21,388,3250100,833,413,420
2008,21,388,3250200,613,311,302
2009,21,388,3250300,1171,574,597
2010,21,388,3250400,1683,835,848
2011,21,388,3250500,2004,1009,995
2012,21,388,3250600,3241,1657,1584
2013,21,388,3250700,782,390,392
2014,21,388,3250800,2075,1001,1074
2015,21,388,3250900,3279,1600,1679
2016,21,388,3251000,886,444,442
2017,21,388,3251100,1886,964,922
2018,21,388,3251200,0,0,0
2019,21,388,3251300,1375,711,664
2020,21,388,3251400,4744,2383,2361
2021,21,388,3251500,4,1,3
2022,21,388,3251600,6695,3354,3341
2023,21,388,3251700,870,452,418
2024,21,388,3251800,2243,1132,1111
2025,21,388,3251900,778,378,400
2026,21,388,3252000,4,4,0
2027,21,388,3252100,209,91,118
2028,21,388,3252200,1840,928,912
2029,21,388,3252300,1057,495,562
2030,21,388,3252400,443,214,229
2031,21,388,3252500,2512,1232,1280
2032,21,388,3252600,1592,813,779
2033,21,388,3252700,2310,1151,1159
2034,21,388,3252800,1615,822,793
2035,21,388,3252900,655,334,321
2036,21,388,3253000,636,315,321
2037,21,388,3253100,1285,657,628
2038,21,388,3253200,1447,746,701
2039,21,388,3253300,1811,952,859
2040,21,388,3253400,1961,912,1049
2041,21,388,3253500,1680,978,702
2042,21,388,3253600,3202,1603,1599
2043,21,388,3253700,799,420,379
2044,21,388,3253800,2373,1206,1167
2045,21,388,3253900,162,95,67
2046,21,388,3254000,730,347,383
2047,21,388,3254100,1536,769,767
2048,21,388,3254200,2785,1411,1374
2049,21,388,3254300,547,274,273
2050,21,388,3254400,163,88,75
2051,21,388,3254500,356,174,182
2052,21,388,3254600,1440,720,720
2053,21,388,3254700,1113,544,569
2054,21,388,3254800,3539,1780,1759
2055,21,388,3254900,1811,839,972
2056,21,388,3255000,7369,4098,3271
2057,21,388,3255100,2268,1039,1229
2058,21,388,3255200,856,383,473
2059,21,388,3255300,3883,1969,1914
2060,21,388,3255400,2336,1186,1150
2061,21,388,3255500,1174,573,601
2062,21,388,3255600,364,165,199
2063,21,388,3255700,932,478,454
2064,21,388,3255800,1515,760,755
2065,21,388,3255900,1234,609,625
2066,21,388,3256000,2120,1056,1064
2067,21,388,3256100,1778,907,871
2068,21,388,3256200,2356,1213,1143
2069,21,388,3256300,2008,1031,977
2070,21,388,3256400,1348,709,639
2071,21,388,3256500,1943,1003,940
2072,21,388,3256600,1166,594,572
2073,21,388,3256700,1977,960,1017
2074,21,388,3256800,501,241,260
2075,21,388,3256900,40,19,21
2076,21,388,3257000,493,252,241
2077,21,388,3257100,1078,531,547
2078,21,388,3257200,657,331,326
2079,21,388,3257300,5565,2791,2774
2080,21,388,3257400,1456,719,737
2081,21,388,3257500,1485,775,710
2082,21,388,3257600,3731,1993,1738
2083,21,388,3257700,1738,880,858
2084,21,388,3257800,1468,737,731
2085,21,388,3257900,1455,753,702
2086,21,388,3258000,1148,573,575
2087,21,388,3258100,861,423,438
2088,21,388,3258200,745,362,383
2089,21,388,3258300,4616,2396,2220
2090,21,388,3258400,2296,1199,1097
2091,21,388,3258500,3803,1916,1887
2092,21,388,3258600,1076,530,546
2093,21,388,3258700,208,106,102
2094,21,388,3258800,1941,968,973
2095,21,388,3258900,2355,1198,1157
2096,21,388,3259000,399,207,192
2097,21,388,3259100,3685,1871,1814
2098,21,388,3259200,1049,516,533
2099,21,388,3259300,1724,829,895
2100,21,388,3259400,1557,773,784
2101,21,388,3259500,5762,2905,2857
2102,21,388,3259600,7964,4186,3778
2103,21,388,3259700,2277,1155,1122
2104,21,388,3259800,5097,2602,2495
2105,21,388,3259900,2297,1180,1117
2106,21,388,3260000,1164,563,601
2107,21,388,3260100,1593,787,806
2108,21,388,3260200,0,0,0
2109,21,388,3260300,3534,1795,1739
2110,21,388,3260400,0,0,0
2111,21,388,3260500,947,509,438
2112,21,388,3260600,0,0,0
2113,21,388,3260700,0,0,0
2114,21,388,3260800,1217,615,602
2115,21,388,3260900,755,394,361
2116,21,388,3261000,0,0,0
2117,21,388,3261100,793,393,400
2118,21,388,3261200,699,361,338
2119,21,388,3261300,1686,830,856
2120,21,388,3261400,1344,686,658
2121,21,388,3261500,577,274,303
2122,21,388,3261600,869,461,408
2123,21,388,3261700,1202,614,588
2124,21,388,3261800,1958,989,969
2125,21,388,3261900,2173,1118,1055
2126,21,388,3262000,1064,556,508
2127,21,388,3262100,710,381,329
2128,21,388,3262200,1906,986,920
2129,21,388,3262300,277,156,121
2130,21,388,3262400,700,334,366
2131,21,388,3262500,3312,1721,1591
2132,21,388,3262600,2126,1091,1035
2133,21,388,3262700,805,414,391
2134,21,388,3262800,2099,1080,1019
2135,21,388,3262900,658,328,330
2136,21,388,3263000,40,21,19
2137,21,388,3263100,116,52,64
2138,21,388,3263200,2672,1305,1367
2139,21,388,3263300,4205,2143,2062
2140,21,388,3263400,2550,1270,1280
2141,21,388,3263500,1030,484,546
2142,21,388,3263600,1024,524,500
2143,21,388,3263700,1822,929,893
2144,21,388,3263800,519,238,281
2145,21,388,3263900,1144,526,618
2146,21,388,3264000,1329,651,678
2147,21,388,3264100,400,184,216
2148,21,388,3264200,1235,598,637
2149,21,388,3264300,616,278,338
2150,21,388,3264400,888,439,449
2151,21,388,3264500,568,291,277
2152,21,388,3264600,973,474,499
2153,21,388,3264700,3106,1513,1593
2154,21,388,3264800,1539,768,771
2155,21,388,3264900,1925,948,977
2156,21,388,3265000,729,357,372
2157,21,388,3265100,637,329,308
2158,21,388,3265200,1861,932,929
2159,21,388,3265300,244,124,120
2160,21,388,3265400,270,128,142
2161,21,388,3265500,277,143,134
2162,21,388,3265600,56,31,25
2163,21,388,3265700,304,153,151
2164,21,388,3265800,374,178,196
2165,21,388,3265900,272,130,142
2166,21,388,3266000,551,270,281
2167,21,388,3266100,224,118,106
2168,21,388,3266200,374,181,193
2169,21,388,3266300,412,192,220
2170,21,388,3266400,1362,649,713
2171,21,388,3266500,326,168,158
2172,21,388,3266600,281,136,145
2173,21,388,3266700,614,313,301
2174,21,388,3266800,143,70,73
2175,21,388,3266900,2810,1350,1460
2176,21,388,3267000,1317,648,669
2177,21,388,3267100,1062,521,541
2178,21,388,3267200,176,86,90
2179,21,388,3267300,1118,523,595
2180,21,388,3267400,438,212,226
2181,21,388,3267500,156,73,83
2182,21,388,3267600,1702,785,917
2183,21,388,3267700,544,249,295
2184,21,388,3267800,342,148,194
2185,21,388,3267900,1132,539,593
2186,21,388,3268000,2198,1099,1099
2187,21,388,3268100,1009,514,495
2188,21,388,3268200,300,143,157
2189,21,388,3268300,483,224,259
2190,21,388,3268400,1087,516,571
2191,21,388,3268500,1680,786,894
2192,21,388,3268600,2236,1096,1140
2193,21,388,3268700,833,390,443
2194,21,388,3268800,2092,962,1130
2195,21,388,3268900,1317,619,698
2196,21,388,3269000,6399,3169,3230
2197,21,388,3269100,0,0,0
2198,21,388,3269200,5753,2934,2819
2199,21,388,3269300,263,122,141
2200,21,388,3269400,1623,800,823
2201,21,388,3269500,255,115,140
2202,21,388,3269600,1371,699,672
2203,21,388,3269700,3710,1854,1856
2204,21,388,3269800,1119,567,552
2205,21,388,3269900,2574,1239,1335
2206,21,388,3270000,1344,673,671
2207,21,388,3270100,526,262,264
2208,21,388,3270200,199,100,99
2209,21,388,3270300,885,459,426
2210,21,388,3270400,329,168,161
2211,21,388,3270500,19,10,9
2212,21,388,3270600,66,33,33
2213,21,388,3270700,249,133,116
2214,21,388,3270800,960,483,477
2215,21,388,3270900,243,122,121
2216,21,388,3271000,0,0,0
2217,21,388,3271100,97,46,51
2218,21,388,3271200,146,71,75
2219,21,388,3271300,163,80,83
2220,21,388,3271400,206,93,113
2221,21,388,3271500,53,24,29
2222,21,388,3271600,697,362,335
2223,21,388,3271700,262,134,128
2224,21,388,3271800,1229,630,599
2225,21,388,3271900,165,89,76
2226,21,388,3272000,228,112,116
2227,21,388,3272100,114,59,55
2228,21,388,3272200,460,232,228
2229,21,388,3272300,273,134,139
2230,21,388,3272400,371,162,209
2231,21,388,3272500,324,150,174
2232,21,388,3272600,68,32,36
2233,21,388,3272700,1806,926,880
2234,21,388,3272800,935,472,463
2235,21,388,3272900,110,54,56
2236,21,388,3273000,549,262,287
2237,21,388,3273100,124,64,60
2238,21,388,3273200,87,39,48
2239,21,388,3273300,79,35,44
2240,21,388,3273400,110,55,55
2241,21,388,3273500,236,118,118
2242,21,388,3273600,733,343,390
2243,21,388,3273700,95,48,47
2244,21,388,3273800,0,0,0
2245,21,388,3273900,82,44,38
2246,21,388,3274000,111,57,54
2247,21,388,3274100,0,0,0
2248,21,388,3274200,0,0,0
2249,21,388,3274300,43,19,24
2250,21,388,3274400,358,186,172
2251,21,388,3274500,49,24,25
2252,21,388,3274600,1011,504,507
2253,21,388,3274700,581,284,297
2254,21,388,3274800,590,278,312
2255,21,388,3274900,100,45,55
2256,21,388,3275000,0,0,0
2257,21,388,3275100,375,181,194
2258,21,388,3275200,1713,838,875
2259,21,388,3275300,434,217,217
2260,21,388,3275400,1017,484,533
2261,21,388,3275500,587,306,281
2262,21,388,3275600,23,8,15
2263,21,388,3275700,0,0,0
2264,21,388,3275800,135,67,68
2265,21,388,3275900,22,12,10
2266,21,388,3276000,16,6,10
2267,21,388,3276100,99,45,54
2268,21,388,3276200,74,38,36
2269,21,388,3276300,9,4,5
2270,21,388,3276400,24,11,13
2271,21,388,3276500,48,23,25
2272,21,388,3276600,56,31,25
2273,21,388,3276700,72,38,34
2274,21,388,3276800,95,49,46
2275,21,388,3276900,69,33,36
2276,21,388,3277000,0,0,0
2277,21,388,3277100,34,16,18
2278,21,388,3277200,1074,556,518
2279,21,388,3277300,106,49,57
2280,21,388,3277400,147,71,76
2281,21,388,3277500,68,38,30
2282,21,388,3277600,82,37,45
2283,21,388,3277700,403,195,208
2284,21,388,3277800,104,48,56
2285,21,388,3277900,464,229,235
2286,21,388,3278000,118,63,55
2287,21,388,3278100,264,131,133
2288,21,388,3278200,665,340,325
2289,21,388,3278300,629,309,320
2290,21,388,3278400,597,284,313
2291,21,388,3278500,79,33,46
2292,21,388,3278600,582,299,283
2293,21,388,3278700,112,56,56
2294,21,388,3278800,62,31,31
2295,21,388,3278900,0,0,0
2296,21,388,3279000,54,28,26
2297,21,388,3279100,0,0,0
2298,21,388,3279200,100,50,50
2299,21,388,3279300,0,0,0
2300,21,388,3279400,79,40,39
2301,21,388,3279500,0,0,0
2302,21,388,3279600,312,156,156
2303,21,388,3279700,0,0,0
2304,21,388,3279800,87,41,46
2305,21,388,3279900,724,356,368
2306,21,388,3280000,283,135,148
2307,21,388,3280100,0,0,0
2308,21,388,3280200,508,264,244
2309,21,388,3280300,590,276,314
2310,21,388,3280400,211,117,94
2311,21,388,3280500,2087,1024,1063
2312,21,388,3280600,748,371,377
2313,21,388,3280700,56,31,25
2314,21,388,3280800,0,0,0
2315,21,388,3280900,224,107,117
2316,21,388,3281000,604,306,298
2317,21,388,3281100,2029,992,1037
2318,21,388,3281200,0,0,0
2319,21,388,3281300,1011,529,482
2320,21,388,3281400,343,174,169
2321,21,388,3281500,74,37,37
2322,21,388,3281600,0,0,0
2323,21,388,3281700,1487,743,744
2324,21,388,3281800,248,118,130
2325,21,388,3281900,153,68,85
2326,21,388,3282000,303,147,156
2327,21,388,3282100,455,231,224
2328,21,388,3282200,625,321,304
2329,21,388,3282300,637,340,297
2330,21,388,3282400,989,480,509
2331,21,388,3282500,745,361,384
2332,21,388,3282600,315,161,154
2333,21,388,3282700,58,31,27
2334,21,388,3282800,36,18,18
2335,21,388,3282900,5,3,2
2336,21,388,3283000,46,23,23
2337,21,388,3283100,54,24,30
2338,21,388,3283200,46,18,28
2339,21,388,3283300,49,26,23
2340,21,388,3283400,415,224,191
2341,21,388,3283500,134,63,71
2342,21,388,3283600,836,412,424
2343,21,388,3283700,780,402,378
2344,21,388,3283800,1531,763,768
2345,21,388,3283900,296,140,156
2346,21,388,3284000,39,20,19
2347,21,388,3284100,0,0,0
2348,21,388,3284200,1918,980,938
2349,21,388,3284300,0,0,0
2350,21,388,3284400,212,112,100
2351,21,388,3284500,94,53,41
2352,21,388,3284600,151,74,77
2353,21,388,3284700,56,27,29
2354,21,388,3284800,3567,1794,1773
2355,21,388,3284900,208,115,93
2356,21,388,3285000,306,157,149
2357,21,388,3285100,537,270,267
2358,21,388,3285200,0,0,0
2359,21,388,3285300,381,185,196
2360,21,388,3285400,152,74,78
2361,21,388,3285500,962,492,470
2362,21,388,3285600,787,382,405
2363,21,388,3285700,152,75,77
2364,21,388,3285800,485,226,259
2365,21,388,3285900,99,52,47
2366,21,388,3286000,338,174,164
2367,21,388,3286100,0,0,0
2368,21,388,3286200,737,343,394
2369,21,388,3286300,156,70,86
2370,21,388,3286400,13,6,7
2371,21,388,3286500,552,273,279
2372,21,388,3286600,919,455,464
2373,21,388,3286700,301,161,140
2374,21,388,3286800,232,123,109
2375,21,388,3286900,170,78,92
2376,21,388,3287000,458,223,235
2377,21,388,3287100,871,413,458
2378,21,388,3287200,924,465,459
2379,21,388,3287300,477,238,239
2380,21,388,3287400,1643,832,811
2381,21,388,3287500,199,97,102
2382,21,388,3287600,1004,513,491
2383,21,388,3287700,198,105,93
2384,21,388,3287800,283,143,140
2385,21,388,3287900,0,0,0
2386,21,388,3288000,0,0,0
2387,21,388,3288100,865,446,419
2388,21,388,3288200,673,324,349
2389,21,388,3288300,199,94,105
2390,21,388,3288400,475,231,244
2391,21,388,3288500,893,412,481
2392,21,388,3288600,457,224,233
2393,21,388,3288700,334,164,170
2394,21,388,3288800,0,0,0
2395,21,388,3288900,92,47,45
2396,21,388,3289000,1149,576,573
2397,21,388,3289100,730,331,399
2398,21,388,3289200,291,147,144
2399,21,388,3289300,0,0,0
2400,21,388,3289400,2292,1054,1238
2401,21,388,3289500,243,125,118
2402,21,388,3289600,976,421,555
2403,21,388,3289700,1018,453,565
2404,21,388,3289800,28,12,16
2405,21,388,3289900,326,159,167
2406,21,388,3290000,373,185,188
2407,21,388,3290100,285,134,151
2408,21,388,3290200,5646,2911,2735
2409,21,388,3290300,2683,1345,1338
2410,21,388,3290400,3191,1600,1591
2411,21,388,3290500,2320,1134,1186
2412,21,388,3290600,596,312,284
2413,21,388,3290700,0,0,0
2414,21,388,3290800,12,6,6
2415,21,388,3290900,1061,567,494
2416,21,388,3291000,894,449,445
2417,21,388,3291100,0,0,0
2418,21,388,3291200,0,0,0
2419,21,388,3291300,372,186,186
2420,21,388,3291400,843,418,425
2421,21,388,3291500,1428,711,717
2422,21,388,3291600,0,0,0
2423,21,388,3291700,1012,476,536
2424,21,388,3291800,1945,1002,943
2425,21,388,3291900,317,143,174
2426,21,388,3292000,639,287,352
2427,21,388,3292100,1517,712,805
2428,21,388,3292200,930,486,444
2429,21,388,3292300,2692,1305,1387
2430,21,388,3292400,712,371,341
2431,21,388,3292500,417,206,211
2432,21,388,3292600,520,260,260
2433,21,388,3292700,345,181,164
2434,21,388,3292800,3506,1773,1733
2435,21,388,3292900,1113,603,510
2436,21,388,3293000,1300,672,628
2437,21,388,3293100,0,0,0
2438,21,388,3293200,497,255,242
2439,21,388,3293300,171,87,84
2440,21,388,3293400,649,320,329
2441,21,388,3293500,158,77,81
2442,21,388,3293600,0,0,0
2443,21,388,3293700,882,463,419
2444,21,388,3293800,455,206,249
2445,21,388,3293900,1055,497,558
2446,21,388,3294000,741,371,370
2447,21,388,3294100,419,195,224
2448,21,388,3294200,256,118,138
2449,21,388,3294300,892,411,481
2450,21,388,3294400,330,146,184
2451,21,388,3294500,1202,584,618
2452,21,388,3294600,768,364,404
2453,21,388,3294700,618,314,304
2454,21,388,3294800,2306,1130,1176
2455,21,388,3294900,889,467,422
2456,21,388,3295000,179,88,91
2457,21,388,3295100,724,349,375
2458,21,388,3295200,0,0,0
2459,21,388,3295300,190,95,95
2460,21,388,3295400,77,41,36
2461,21,388,3295500,778,390,388
2462,21,388,3295600,0,0,0
2463,21,388,3295700,404,205,199
2464,21,388,3295800,953,492,461
2465,21,388,3295900,980,502,478
2466,21,388,3296000,0,0,0
2467,21,388,3296100,1004,497,507
2468,21,388,3296200,1217,606,611
2469,21,388,3296300,1227,637,590
2470,21,388,3296400,489,248,241
2471,21,388,3296500,1455,692,763
2472,21,388,3296600,376,190,186
2473,21,388,3296700,2,1,1
2474,21,388,3296800,229,119,110
2475,21,388,3296900,849,421,428
2476,21,388,3297000,911,469,442
2477,21,388,3297100,732,374,358
2478,21,388,3297200,1224,612,612
2479,21,388,3297300,0,0,0
2480,21,388,3297400,401,202,199
2481,21,388,3297500,258,141,117
2482,21,388,3297600,564,280,284
2483,21,388,3297700,629,314,315
2484,21,388,3297800,143,73,70
2485,21,388,3297900,343,181,162
2486,21,388,3298000,131,75,56
2487,21,388,3298100,1483,724,759
2488,21,388,3298200,569,273,296
2489,21,388,3298300,953,437,516
2490,21,388,3298400,848,381,467
2491,21,388,3298500,599,265,334
2492,21,388,3298600,1721,844,877
2493,21,388,3298700,115,59,56
2494,21,388,3298800,132,68,64
2495,21,388,3298900,122,60,62
2496,21,388,3299000,106,48,58
2497,21,388,3299100,80,37,43
2498,21,388,3299200,0,0,0
2499,21,388,3299300,0,0,0
2500,21,388,3299400,62,33,29
2501,21,388,3299500,161,74,87
2502,21,388,3299600,232,128,104
2503,21,388,3299700,108,48,60
2504,21,388,3299800,106,53,53
2505,21,388,3299900,14,11,3
2506,21,388,3300000,1336,672,664
2507,21,388,3300100,68,32,36
2508,21,388,3300200,38,20,18
2509,21,388,3300300,113,62,51
2510,21,388,3300400,3137,1626,1511
2511,21,388,3300500,2480,1264,1216
2512,21,388,3300600,60,29,31
2513,21,388,3300700,173,85,88
2514,21,388,3300800,149,70,79
2515,21,388,3300900,539,253,286
2516,21,388,3301000,97,43,54
2517,21,388,3301100,0,0,0
2518,21,388,3301200,64,31,33
2519,21,388,3301300,24,13,11
2520,21,388,3301400,0,0,0
2521,21,388,3301500,36,16,20
2522,21,388,3301600,0,0,0
2523,21,388,3301700,0,0,0
2524,21,388,3301800,100,50,50
2525,21,388,3301900,174,85,89
2526,21,388,3302000,62,31,31
2527,21,388,3302100,122,56,66
2528,21,388,3302200,1517,725,792
2529,21,388,3302300,181,90,91
2530,21,388,3302400,826,435,391
2531,21,388,3302500,703,324,379
2532,21,388,3302600,252,123,129
2533,21,388,3302700,807,399,408
2534,21,388,3302800,674,331,343
2535,21,388,3302900,141,69,72
2536,21,388,3303000,281,140,141
2537,21,388,3303100,410,205,205
2538,21,388,3303200,58,34,24
2539,21,388,3303300,836,424,412
2540,21,388,3303400,468,233,235
2541,21,388,3303500,389,202,187
2542,21,388,3303600,0,0,0
2543,21,388,3303700,770,396,374
2544,21,388,3303800,1427,692,735
2545,21,388,3303900,93,50,43
2546,21,388,3304000,43,21,22
2547,21,388,3304100,294,158,136
2548,21,388,3304200,230,121,109
2549,21,388,3304300,162,81,81
2550,21,388,3304400,251,132,119
2551,21,388,3304500,2073,1039,1034
2552,21,388,3304600,80,39,41
2553,21,388,3304700,0,0,0
2554,21,388,3304800,182,98,84
2555,21,388,3304900,74,38,36
2556,21,388,3305000,70,43,27
2557,21,388,3305100,68,31,37
2558,21,388,3305200,78,42,36
2559,21,388,3305300,0,0,0
2560,21,388,3305400,19,8,11
2561,21,388,3305500,73,41,32
2562,21,388,3305600,45,24,21
2563,21,388,3305700,0,0,0
2564,21,388,3305800,0,0,0
2565,21,388,3305900,271,136,135
2566,21,388,3306000,0,0,0
2567,21,388,3306100,124,65,59
2568,21,388,3306200,1,1,0
2569,21,388,3306300,2568,1295,1273
2570,21,388,3306400,58,27,31
2571,21,388,3306500,0,0,0
2572,21,388,3306600,87,43,44
2573,21,388,3306700,93,50,43
2574,21,388,3306800,0,0,0
2575,21,388,3306900,74,40,34
2576,21,388,3307000,145,81,64
2577,21,388,3307100,238,108,130
2578,21,388,3307200,140,62,78
2579,21,388,3307300,213,101,112
2580,21,388,3307400,76,39,37
2581,21,388,3307500,59,32,27
2582,21,388,3307600,102,55,47
2583,21,388,3307700,168,86,82
2584,21,388,3307800,64,35,29
2585,21,388,3307900,0,0,0
2586,21,388,3308000,0,0,0
2587,21,388,3308100,669,331,338
2588,21,388,3308200,0,0,0
2589,21,388,3308300,1473,748,725
2590,21,388,3308400,462,230,232
2591,21,388,3308500,273,129,144
2592,21,388,3308600,366,180,186
2593,21,388,3308700,0,0,0
2594,21,388,3308800,716,367,349
2595,21,388,3308900,611,331,280
2596,21,388,3309000,641,311,330
2597,21,388,3309100,547,273,274
2598,21,388,3309200,618,292,326
2599,21,388,3309300,1449,722,727
2600,21,388,3309400,0,0,0
2601,21,388,3309500,438,217,221
2602,21,388,3309600,0,0,0
2603,21,388,3309700,0,0,0
2604,21,388,3309800,531,258,273
2605,21,388,3309900,0,0,0
2606,21,388,3310000,1009,524,485
2607,21,388,3310100,0,0,0
2608,21,388,3310200,7,5,2
2609,21,388,3310300,0,0,0
2610,21,388,3310400,0,0,0
2611,21,388,3310500,235,122,113
2612,21,388,3310600,157,83,74
2613,21,388,3310700,376,190,186
2614,21,388,3310800,228,108,120
2615,21,388,3310900,452,233,219
2616,21,388,3311000,799,406,393
2617,21,388,3311100,961,452,509
2618,21,388,3311200,1068,509,559
2619,21,388,3311300,1276,613,663
2620,21,388,3311400,935,480,455
2621,21,388,3311500,346,182,164
2622,21,388,3311600,1474,752,722
2623,21,388,3311700,893,451,442
2624,21,388,3311800,387,190,197
2625,21,388,3311900,1622,813,809
2626,21,388,3312000,1522,749,773
2627,21,388,3312100,374,187,187
2628,21,388,3312200,387,174,213
2629,21,388,3312300,0,0,0
2630,21,388,3312400,0,0,0
2631,21,388,3312500,0,0,0
2632,21,388,3312600,228,119,109
2633,21,388,3312700,0,0,0
2634,21,388,3312800,0,0,0
2635,21,388,3312900,1199,611,588
2636,21,388,3313000,737,347,390
2637,21,388,3313100,0,0,0
2638,21,388,3313200,0,0,0
2639,21,388,3313300,0,0,0
2640,21,388,3313400,379,190,189
2641,21,388,3313500,32,15,17
2642,21,388,3313600,11,5,6
2643,21,388,3313700,104,53,51
2644,21,388,3313800,0,0,0
2645,21,388,3313900,0,0,0
2646,21,388,3314000,33,19,14
2647,21,388,3314100,12,6,6
2648,21,388,3314200,81,39,42
2649,21,388,3314300,65,40,25
2650,21,388,3314400,0,0,0
2651,21,388,3314500,133,62,71
2652,21,388,3314600,181,94,87
2653,21,388,3314700,381,192,189
2654,21,388,3314800,447,237,210
2655,21,388,3314900,862,443,419
2656,21,388,3315000,133,80,53
2657,21,388,3315100,192,97,95
2658,21,388,3315200,94,47,47
2659,21,388,3315300,63,31,32
2660,21,388,3315400,0,0,0
2661,21,388,3315500,901,449,452
2662,21,388,3315600,81,43,38
2663,21,388,3315700,0,0,0
2664,21,388,3315800,0,0,0
2665,21,388,3315900,394,182,212
2666,21,388,3316000,0,0,0
2667,21,388,3316100,886,418,468
2668,21,388,3316200,245,113,132
2669,21,388,3316300,433,221,212
2670,21,388,3316400,2481,1267,1214
2671,21,388,3316500,199,91,108
2672,21,388,3316600,234,122,112
2673,21,388,3316700,278,120,158
2674,21,388,3316800,0,0,0
2675,21,388,3316900,112,58,54
2676,21,388,3317000,851,443,408
2677,21,388,3317100,473,230,243
2678,21,388,3317200,5314,2684,2630
2679,21,388,3317300,314,155,159
2680,21,388,3317400,324,163,161
2681,21,388,3317500,488,233,255
2682,21,388,3317600,183,91,92
2683,21,388,3317700,321,135,186
2684,21,388,3317800,167,82,85
2685,21,388,3317900,0,0,0
2686,21,388,3318000,46,21,25
2687,21,388,3318100,0,0,0
2688,21,388,3318200,0,0,0
2689,21,388,3318300,24,14,10
2690,21,388,3318400,94,44,50
2691,21,388,3318500,31,11,20
2692,21,388,3318600,0,0,0
2693,21,388,3318700,49,18,31
2694,21,388,3318800,52,25,27
2695,21,388,3318900,72,41,31
2696,21,388,3319000,49,25,24
2697,21,388,3319100,302,153,149
2698,21,388,3319200,0,0,0
2699,21,388,3319300,43,20,23
2700,21,388,3319400,0,0,0
2701,21,388,3319500,36,20,16
2702,21,388,3319600,0,0,0
2703,21,388,3319700,0,0,0
2704,21,388,3319800,0,0,0
2705,21,388,3319900,0,0,0
2706,21,388,3320000,49,28,21
2707,21,388,3320100,31,14,17
2708,21,388,3320200,0,0,0
2709,21,388,3320300,17,6,11
2710,21,388,3320400,0,0,0
2711,21,388,3320500,31,18,13
2712,21,388,3320600,12,6,6
2713,21,388,3320700,4,1,3
2714,21,388,3320800,30,14,16
2715,21,388,3320900,0,0,0
2716,21,388,3321000,37,20,17
2717,21,388,3321100,21,11,10
2718,21,388,3321200,0,0,0
2719,21,388,3321300,68,35,33
2720,21,388,3321400,47,28,19
2721,21,388,3321500,0,0,0
2722,21,388,3321600,704,354,350
2723,21,388,3321700,424,197,227
2724,21,388,3321800,271,134,137
2725,21,388,3321900,612,311,301
2726,21,388,3322000,200,96,104
2727,21,388,3322100,743,387,356
2728,21,388,3322200,1043,522,521
2729,21,388,3322300,562,256,306
2730,21,388,3322400,1303,621,682
2731,21,388,3322500,292,136,156
2732,21,388,3322600,1151,520,631
2733,21,388,3322700,405,187,218
2734,21,388,3322800,523,256,267
2735,21,388,3322900,799,367,432
2736,21,388,3323000,624,302,322
2737,21,388,3323100,284,149,135
2738,21,388,3323200,1325,669,656
2739,21,388,3323300,885,441,444
2740,21,388,3323400,12,5,7
2741,21,388,3323500,520,261,259
2742,21,388,3323600,33,12,21
2743,21,388,3323700,36,19,17
2744,21,388,3323800,27,12,15
2745,21,388,3323900,0,0,0
2746,21,388,3324000,33,13,20
2747,21,388,3324100,12,4,8
2748,21,388,3324200,81,37,44
2749,21,388,3324300,562,282,280
2750,21,388,3324400,293,149,144
2751,21,388,3324500,698,343,355
2752,21,388,3324600,1149,562,587
2753,21,388,3324700,282,121,161
2754,21,388,3324800,1168,482,686
2755,21,388,3324900,1169,595,574
2756,21,388,3325000,0,0,0
2757,21,388,3325100,335,176,159
2758,21,388,3325200,0,0,0
2759,21,388,3325300,830,404,426
2760,21,388,3325400,974,439,535
2761,21,388,3325500,559,247,312
2762,21,388,3325600,749,354,395
2763,21,388,3325700,312,143,169
2764,21,388,3325800,751,371,380
2765,21,388,3325900,1355,564,791
2766,21,388,3326000,660,291,369
2767,21,388,3326100,376,146,230
2768,21,388,3326200,3193,1525,1668
2769,21,388,3326300,564,249,315
2770,21,388,3326400,610,304,306
2771,21,388,3326500,474,210,264
2772,21,388,3326600,605,265,340
2773,21,388,3326700,608,278,330
2774,21,388,3326800,455,211,244
2775,21,388,3326900,200,106,94
2776,21,388,3327000,239,116,123
2777,21,388,3327100,526,243,283
2778,21,388,3327200,124,56,68
2779,21,388,3327300,994,495,499
2780,21,388,3327400,301,148,153
2781,21,388,3327500,2199,1068,1131
2782,21,388,3327600,25,12,13
2783,21,388,3327700,18,6,12
2784,21,388,3327800,93,43,50
2785,21,388,3327900,896,462,434
2786,21,388,3328000,191,94,97
2787,21,388,3328100,317,156,161
2788,21,388,3328200,718,363,355
2789,21,388,3328300,59,33,26
2790,21,388,3328400,281,121,160
2791,21,388,3328500,798,381,417
2792,21,388,3328600,74,35,39
2793,21,388,3328700,49,23,26
2794,21,388,3328800,383,188,195
2795,21,388,3328900,119,64,55
2796,21,388,3329000,86,44,42
2797,21,388,3329100,421,212,209
2798,21,388,3329200,336,156,180
2799,21,388,3329300,78,40,38
2800,21,388,3329400,0,0,0
2801,21,388,3329500,1899,932,967
2802,21,388,3329600,686,320,366
2803,21,388,3329700,1018,417,601
2804,21,388,3329800,924,430,494
2805,21,388,3329900,72,38,34
2806,21,388,3330000,123,61,62
2807,21,388,3330100,130,68,62
2808,21,388,3330200,183,91,92
2809,21,388,3330300,250,124,126
2810,21,388,3330400,82,31,51
2811,21,388,3330500,373,172,201
2812,21,388,3330600,187,92,95
2813,21,388,3330700,37,18,19
2814,21,388,3330800,18,8,10
2815,21,388,3330900,124,59,65
2816,21,388,3331000,39,24,15
2817,21,388,3331100,79,43,36
2818,21,388,3331200,26,16,10
2819,21,388,3331300,112,56,56
2820,21,388,3331400,30,12,18
2821,21,388,3331500,111,45,66
2822,21,388,3331600,210,99,111
2823,21,388,3331700,0,0,0
2824,21,388,3331800,0,0,0
2825,21,388,3331900,66,31,35
2826,21,388,3332000,221,96,125
2827,21,388,3332100,59,26,33
2828,21,388,3332200,456,217,239
2829,21,388,3332300,121,48,73
2830,21,388,3332400,491,302,189
2831,21,388,3332500,203,102,101
2832,21,388,3332600,308,144,164
2833,21,388,3332700,159,69,90
2834,21,388,3332800,137,69,68
2835,21,388,3332900,68,31,37
2836,21,388,3333000,93,47,46
2837,21,388,3333100,169,90,79
2838,21,388,3333200,143,70,73
2839,21,388,3333300,716,376,340
2840,21,388,3333400,279,149,130
2841,21,388,3333500,1153,563,590
2842,21,388,3333600,5844,2954,2890
2843,21,388,3333700,604,300,304
2844,21,388,3333800,1055,543,512
2845,21,388,3333900,547,265,282
2846,21,388,3334000,333,182,151
2847,21,388,3334100,1337,655,682
2848,21,388,3334200,1151,583,568
2849,21,388,3334300,985,516,469
2850,21,388,3334400,968,499,469
2851,21,388,3334500,658,345,313
2852,21,388,3334600,1153,574,579
2853,21,388,3334700,525,267,258
2854,21,388,3334800,1126,582,544
2855,21,388,3334900,600,316,284
2856,21,388,3335000,811,399,412
2857,21,388,3335100,155,73,82
2858,21,388,3335200,0,0,0
2859,21,388,3335300,0,0,0
2860,21,388,3335400,0,0,0
2861,21,388,3335500,901,483,418
2862,21,388,3335600,262,144,118
2863,21,388,3335700,0,0,0
2864,21,388,3335800,1636,807,829
2865,21,388,3335900,910,467,443
2866,21,388,3336000,0,0,0
2867,21,388,3336100,2729,1403,1326
2868,21,388,3336200,886,417,469
2869,21,388,3336300,1330,697,633
2870,21,388,3336400,487,212,275
2871,21,388,3336500,869,412,457
2872,21,388,3336600,461,227,234
2873,21,388,3336700,879,435,444
2874,21,388,3336800,888,446,442
2875,21,388,3336900,1167,599,568
2876,21,388,3337000,2360,1225,1135
2877,21,388,3337100,543,272,271
2878,21,388,3337200,478,247,231
2879,21,388,3337300,438,224,214
2880,21,388,3337400,2443,1214,1229
2881,21,388,3337500,1572,836,736
2882,21,388,3337600,74,39,35
2883,21,388,3337700,95,49,46
2884,21,388,3337800,206,101,105
2885,21,388,3337900,0,0,0
2886,21,388,3338000,0,0,0
2887,21,388,3338100,0,0,0
2888,21,388,3338200,1230,637,593
2889,21,388,3338300,621,270,351
2890,21,388,3338400,426,212,214
2891,21,388,3338500,165,89,76
2892,21,388,3338600,493,253,240
2893,21,388,3338700,1080,564,516
2894,21,388,3338800,286,149,137
2895,21,388,3338900,768,402,366
2896,21,388,3339000,737,363,374
2897,21,388,3339100,1258,662,596
2898,21,388,3339200,990,492,498
2899,21,388,3339300,1616,787,829
2900,21,388,3339400,4639,2387,2252
2901,21,388,3339500,633,331,302
2902,21,388,3339600,34,19,15
2903,21,388,3339700,39,18,21
2904,21,388,3339800,1757,936,821
2905,21,388,3339900,449,225,224
2906,21,388,3340000,2685,1444,1241
2907,21,388,3340100,715,370,345
2908,21,388,3340200,729,398,331
2909,21,388,3340300,1260,660,600
2910,21,388,3340400,2071,1075,996
2911,21,388,3340500,0,0,0
2912,21,388,3340600,530,274,256
2913,21,388,3340700,212,106,106
2914,21,388,3340800,839,437,402
2915,21,388,3340900,936,502,434
2916,21,388,3341000,1497,742,755
2917,21,388,3341100,4515,2394,2121
2918,21,388,3341200,2282,1238,1044
2919,21,388,3341300,2875,1522,1353
2920,21,388,3341400,366,185,181
2921,21,388,3341500,2317,1152,1165
2922,21,388,3341600,0,0,0
2923,21,388,3341700,1041,561,480
2924,21,388,3341800,1182,562,620
2925,21,388,3341900,17,8,9
2926,21,388,3342000,756,399,357
2927,21,388,3342100,0,0,0
2928,21,388,3342200,1673,861,812
2929,21,388,3342300,202,99,103
2930,21,388,3342400,175,91,84
2931,21,388,3342500,32,12,20
2932,21,388,3342600,199,97,102
2933,21,388,3342700,445,219,226
2934,21,388,3342800,0,0,0
2935,21,388,3342900,987,510,477
2936,21,388,3343000,49,25,24
2937,21,388,3343100,84,42,42
2938,21,388,3343200,652,330,322
2939,21,388,3343300,222,112,110
2940,21,388,3343400,0,0,0
2941,21,388,3343500,319,153,166
2942,21,388,3343600,211,109,102
2943,21,388,3343700,880,438,442
2944,21,388,3343800,201,92,109
2945,21,388,3343900,316,156,160
2946,21,388,3344000,322,152,170
2947,21,388,3344100,0,0,0
2948,21,388,3344200,337,172,165
2949,21,388,3344300,1080,524,556
2950,21,388,3344400,930,467,463
2951,21,388,3344500,413,203,210
2952,21,388,3344600,317,168,149
2953,21,388,3344700,249,126,123
2954,21,388,3344800,173,88,85
2955,21,388,3344900,576,259,317
2956,21,388,3345000,335,166,169
2957,21,388,3345100,60,35,25
2958,21,388,3345200,99,44,55
2959,21,388,3345300,0,0,0
2960,21,388,3345400,93,47,46
2961,21,388,3345500,1417,695,722
2962,21,388,3345600,148,67,81
2963,21,388,3345700,394,195,199
2964,21,388,3345800,1123,583,540
2965,21,388,3345900,1526,746,780
2966,21,388,3346000,5002,2521,2481
2967,21,388,3346100,2560,1320,1240
2968,21,388,3346200,805,405,400
2969,21,388,3346300,704,362,342
2970,21,388,3346400,2460,1283,1177
2971,21,388,3346500,1035,530,505
2972,21,388,3346600,920,484,436
2973,21,388,3346700,3416,1761,1655
2974,21,388,3346800,1792,923,869
2975,21,388,3346900,0,0,0
2976,21,388,3347000,563,296,267
2977,21,388,3347100,0,0,0
2978,21,388,3347200,948,472,476
2979,21,388,3347300,344,158,186
2980,21,388,3347400,381,206,175
2981,21,388,3347500,1349,705,644
2982,21,388,3347600,493,262,231
2983,21,388,3347700,604,302,302
2984,21,388,3347800,947,524,423
2985,21,388,3347900,168,84,84
2986,21,388,3348000,884,476,408
2987,21,388,3348100,384,175,209
2988,21,388,3348200,370,175,195
2989,21,388,3348300,746,362,384
2990,21,388,3348400,6,4,2
2991,21,388,3348500,431,211,220
2992,21,388,3348600,5027,2469,2558
2993,21,388,3348700,2901,1463,1438
2994,21,388,3348800,1139,583,556
2995,21,388,3348900,5003,2521,2482
2996,21,388,3349000,749,367,382
2997,21,388,3349100,36,15,21
2998,21,388,3349200,1184,624,560
2999,21,388,3349300,657,329,328
3000,21,388,3349400,67,31,36
3001,21,388,3349500,23,14,9
3002,21,388,3349600,0,0,0
3003,21,388,3349700,202,105,97
3004,21,388,3349800,93,41,52
3005,21,388,3349900,184,86,98
3006,21,388,3350000,27,13,14
3007,21,388,3350100,266,133,133
3008,21,388,3350200,391,193,198
3009,21,388,3350300,90,44,46
3010,21,388,3350400,490,243,247
3011,21,388,3350500,25,11,14
3012,21,388,3350600,390,204,186
3013,21,388,3350700,177,83,94
3014,21,388,3350800,481,239,242
3015,21,388,3350900,232,119,113
3016,21,388,3351000,168,87,81
3017,21,388,3351100,694,367,327
3018,21,388,3351200,377,199,178
3019,21,388,3351300,608,315,293
3020,21,388,3351400,372,171,201
3021,21,388,3351500,558,285,273
3022,21,388,3351600,1092,572,520
3023,21,388,3351700,1068,512,556
3024,21,388,3351800,312,143,169
3025,21,388,3351900,1215,591,624
3026,21,388,3352000,2760,1428,1332
3027,21,388,3352100,900,462,438
3028,21,388,3352200,482,238,244
3029,21,388,3352300,824,419,405
3030,21,388,3352400,978,497,481
3031,21,388,3352500,0,0,0
3032,21,388,3352600,716,381,335
3033,21,388,3352700,193,101,92
3034,21,388,3352800,0,0,0
3035,21,388,3352900,3065,1496,1569
3036,21,388,3353000,3786,1873,1913
3037,21,388,3353100,1484,789,695
3038,21,388,3353200,1548,720,828
3039,21,388,3353300,2528,1255,1273
3040,21,388,3353400,5042,2554,2488
3041,21,388,3353500,1880,944,936
3042,21,388,3353600,1670,810,860
3043,21,388,3353700,1009,488,521
3044,21,388,3353800,2986,1461,1525
3045,21,388,3353900,2307,1092,1215
3046,21,388,3354000,1568,775,793
3047,21,388,3354100,1419,668,751
3048,21,388,3354200,1243,605,638
3049,21,388,3354300,3721,1914,1807
3050,21,388,3354400,5332,2582,2750
3051,21,388,3354500,367,175,192
3052,21,388,3354600,532,270,262
3053,21,388,3354700,452,229,223
3054,21,388,3354800,0,0,0
3055,21,388,3354900,2117,1136,981
3056,21,388,3355000,927,498,429
3057,21,388,3355100,0,0,0
3058,21,388,3355200,855,452,403
3059,21,388,3355300,1705,919,786
3060,21,388,3355400,2243,1133,1110
3061,21,388,3355500,1279,622,657
3062,21,388,3355600,504,266,238
3063,21,388,3355700,792,398,394
3064,21,388,3355800,684,394,290
3065,21,388,3355900,1768,908,860
3066,21,388,3356000,944,505,439
3067,21,388,3356100,863,440,423
3068,21,388,3356200,454,228,226
3069,21,388,3356300,861,424,437
3070,21,388,3356400,2819,1352,1467
3071,21,388,3356500,1430,667,763
3072,21,388,3356600,2527,1210,1317
3073,21,388,3356700,759,363,396
3074,21,388,3356800,2587,1268,1319
3075,21,388,3356900,1780,829,951
3076,21,388,3357000,2423,1193,1230
3077,21,388,3357100,1851,905,946
3078,21,388,3357200,908,429,479
3079,21,388,3357300,1549,749,800
3080,21,388,3357400,668,319,349
3081,21,388,3357500,1509,718,791
3082,21,388,3357600,62,27,35
3083,21,388,3357700,1346,684,662
3084,21,388,3357800,2116,912,1204
3085,21,388,3357900,1627,762,865
3086,21,388,3358000,993,466,527
3087,21,388,3358100,1873,941,932
3088,21,388,3358200,2111,1030,1081
3089,21,388,3358300,639,302,337
3090,21,388,3358400,1161,553,608
3091,21,388,3358500,4210,2045,2165
3092,21,388,3358600,1222,597,625
3093,21,388,3358700,3950,1913,2037
3094,21,388,3358800,495,249,246
3095,21,388,3358900,0,0,0
3096,21,388,3359000,0,0,0
3097,21,388,3359100,0,0,0
3098,21,388,3359200,467,230,237
3099,21,388,3359300,649,325,324
3100,21,388,3359400,827,379,448
3101,21,388,3359500,564,284,280
3102,21,388,3359600,1976,942,1034
3103,21,388,3359700,0,0,0
3104,21,388,3359800,12,7,5
3105,21,388,3359900,0,0,0
3106,21,388,3360000,42,22,20
3107,21,388,3360100,18,7,11
3108,21,388,3360200,32,11,21
3109,21,388,3360300,63,31,32
3110,21,388,3360400,25,12,13
3111,21,388,3360500,62,34,28
3112,21,388,3360600,0,0,0
3113,21,388,3360700,49,24,25
3114,21,388,3360800,34,15,19
3115,21,388,3360900,38,20,18
3116,21,388,3361000,17,6,11
3117,21,388,3361100,34,18,16
3118,21,388,3361200,132,68,64
3119,21,388,3361300,94,48,46
3120,21,388,3361400,170,84,86
3121,21,388,3361500,71,40,31
3122,21,388,3361600,35,17,18
3123,21,388,3361700,46,25,21
3124,21,388,3361800,16,6,10
3125,21,388,3361900,42,24,18
3126,21,388,3362000,40,19,21
3127,21,388,3362100,100,56,44
3128,21,388,3362200,119,60,59
3129,21,388,3362300,235,119,116
3130,21,388,3362400,15,7,8
3131,21,388,3362500,0,0,0
3132,21,388,3362600,16,9,7
3133,21,388,3362700,61,33,28
3134,21,388,3362800,90,43,47
3135,21,388,3362900,26,14,12
3136,21,388,3363000,93,53,40
3137,21,388,3363100,113,52,61
3138,21,388,3363200,37,21,16
3139,21,388,3363300,202,108,94
3140,21,388,3363400,199,103,96
3141,21,388,3363500,39,20,19
3142,21,388,3363600,93,46,47
3143,21,388,3363700,91,42,49
3144,21,388,3363800,31,14,17
3145,21,388,3363900,50,27,23
3146,21,388,3364000,0,0,0
3147,21,388,3364100,26,12,14
3148,21,388,3364200,75,37,38
3149,21,388,3364300,124,59,65
3150,21,388,3364400,10,5,5
3151,21,388,3364500,49,26,23
3152,21,388,3364600,0,0,0
3153,21,388,3364700,20,13,7
3154,21,388,3364800,106,49,57
3155,21,388,3364900,64,34,30
3156,21,388,3365000,164,74,90
3157,21,388,3365100,17,8,9
3158,21,388,3365200,73,36,37
3159,21,388,3365300,99,45,54
3160,21,388,3365400,68,37,31
3161,21,388,3365500,92,40,52
3162,21,388,3365600,87,44,43
3163,21,388,3365700,102,56,46
3164,21,388,3365800,827,448,379
3165,21,388,3365900,27,14,13
3166,21,388,3366000,90,37,53
3167,21,388,3366100,15,8,7
3168,21,388,3366200,35,13,22
3169,21,388,3366300,31,12,19
3170,21,388,3366400,96,48,48
3171,21,388,3366500,97,51,46
3172,21,388,3366600,348,246,102
3173,21,388,3366700,75,36,39
3174,21,388,3366800,136,68,68
3175,21,388,3366900,91,43,48
3176,21,388,3367000,17,8,9
3177,21,388,3367100,0,0,0
3178,21,388,3367200,201,95,106
3179,21,388,3367300,0,0,0
3180,21,388,3367400,99,56,43
3181,21,388,3367500,219,106,113
3182,21,388,3367600,98,46,52
3183,21,388,3367700,96,50,46
3184,21,388,3367800,23,12,11
3185,21,388,3367900,142,66,76
3186,21,388,3368000,61,26,35
3187,21,388,3368100,111,55,56
3188,21,388,3368200,24,13,11
3189,21,388,3368300,28,16,12
3190,21,388,3368400,139,72,67
3191,21,388,3368500,165,74,91
3192,21,388,3368600,38,15,23
3193,21,388,3368700,93,49,44
3194,21,388,3368800,87,46,41
3195,21,388,3368900,0,0,0
3196,21,388,3369000,71,32,39
3197,21,388,3369100,59,24,35
3198,21,388,3369200,99,53,46
3199,21,388,3369300,104,56,48
3200,21,388,3369400,149,80,69
3201,21,388,3369500,309,156,153
3202,21,388,3369600,0,0,0
3203,21,388,3369700,38,21,17
3204,21,388,3369800,37,17,20
3205,21,388,3369900,49,24,25
3206,21,388,3370000,47,24,23
3207,21,388,3370100,92,43,49
3208,21,388,3370200,15,7,8
3209,21,388,3370300,79,42,37
3210,21,388,3370400,37,16,21
3211,21,388,3370500,74,37,37
