,Statecode,Districtcode,VillageCode,Population,Males,Females
0,21,24,4001600,62,28,34
1,21,24,4001700,142,70,72
2,21,24,4001800,62,29,33
3,21,24,4001900,807,400,407
4,21,24,4002000,136,71,65
5,21,24,4002100,666,307,359
6,21,24,4002200,484,240,244
7,21,24,4002300,331,154,177
8,21,24,4002400,436,223,213
9,21,24,4002500,424,215,209
10,21,24,4002600,266,143,123
11,21,24,4002700,844,413,431
12,21,24,4002800,697,335,362
13,21,24,4002900,388,181,207
14,21,24,4003000,636,319,317
15,21,24,4003100,834,408,426
16,21,24,4003200,253,127,126
17,21,24,4003300,170,78,92
18,21,24,4003400,421,203,218
19,21,24,4003500,645,328,317
20,21,24,4003600,609,301,308
21,21,24,4003700,195,93,102
22,21,24,4003800,154,70,84
23,21,24,4003900,577,294,283
24,21,24,4004000,211,111,100
25,21,24,4004100,163,77,86
26,21,24,4004200,390,188,202
27,21,24,4004300,379,187,192
28,21,24,4004400,142,65,77
29,21,24,4004500,218,98,120
30,21,24,4004600,181,86,95
31,21,24,4004700,583,285,298
32,21,24,4004800,402,210,192
33,21,24,4004900,405,193,212
34,21,24,4005000,71,36,35
35,21,24,4005100,208,103,105
36,21,24,4005200,374,191,183
37,21,24,4005300,471,228,243
38,21,24,4005400,560,288,272
39,21,24,4005500,346,143,203
40,21,24,4005600,798,374,424
41,21,24,4005700,833,397,436
42,21,24,4005800,329,165,164
43,21,24,4005900,826,418,408
44,21,24,4006000,450,221,229
45,21,24,4006100,666,324,342
46,21,24,4006200,105,46,59
47,21,24,4006300,100,46,54
48,21,24,4006400,388,194,194
49,21,24,4006500,451,222,229
50,21,24,4006600,195,95,100
51,21,24,4006700,48,29,19
52,21,24,4006800,774,388,386
53,21,24,4006900,378,196,182
54,21,24,4007000,407,201,206
55,21,24,4007100,567,283,284
56,21,24,4007200,279,140,139
57,21,24,4007300,211,99,112
58,21,24,4007400,699,381,318
59,21,24,4007500,492,252,240
60,21,24,4007600,856,399,457
61,21,24,4007700,0,0,0
62,21,24,4007800,446,219,227
63,21,24,4007900,804,399,405
64,21,24,4008000,215,110,105
65,21,24,4008100,627,307,320
66,21,24,4008200,343,168,175
67,21,24,4008300,357,168,189
68,21,24,4008400,526,258,268
69,21,24,4008500,1108,541,567
70,21,24,4008600,664,343,321
71,21,24,4008700,2476,1249,1227
72,21,24,4008800,642,330,312
73,21,24,4008900,292,140,152
74,21,24,4009000,139,70,69
75,21,24,4009100,1556,787,769
76,21,24,4009200,632,328,304
77,21,24,4009300,500,268,232
78,21,24,4009400,338,164,174
79,21,24,4009500,556,271,285
80,21,24,4009600,579,312,267
81,21,24,4009700,247,117,130
82,21,24,4009800,169,80,89
83,21,24,4009900,625,314,311
84,21,24,4010000,540,334,206
85,21,24,4010100,540,276,264
86,21,24,4010200,272,128,144
87,21,24,4010300,668,331,337
88,21,24,4010400,258,119,139
89,21,24,4010500,798,395,403
90,21,24,4010600,299,146,153
91,21,24,4010700,3742,1911,1831
92,21,24,4010800,808,408,400
93,21,24,4010900,374,181,193
94,21,24,4011000,242,117,125
95,21,24,4011100,793,395,398
96,21,24,4011200,158,87,71
97,21,24,4011300,104,50,54
98,21,24,4011400,314,157,157
99,21,24,4011500,477,255,222
100,21,24,4011600,420,216,204
101,21,24,4011700,492,245,247
102,21,24,4011800,1155,584,571
103,21,24,4011900,332,167,165
104,21,24,4012000,246,117,129
105,21,24,4012100,626,323,303
106,21,24,4012200,179,81,98
107,21,24,4012300,420,197,223
108,21,24,4012400,290,140,150
109,21,24,4012500,1235,628,607
110,21,24,4012600,284,147,137
111,21,24,4012700,424,194,230
112,21,24,4012800,494,244,250
113,21,24,4012900,976,503,473
114,21,24,4013000,387,192,195
115,21,24,4013100,85,48,37
116,21,24,4013200,110,46,64
117,21,24,4013300,213,112,101
118,21,24,4013400,258,130,128
119,21,24,4013500,431,205,226
120,21,24,4013600,546,255,291
121,21,24,4013700,666,328,338
122,21,24,4013800,333,168,165
123,21,24,4013900,410,206,204
124,21,24,4014000,152,76,76
125,21,24,4014100,315,151,164
126,21,24,4014200,528,269,259
127,21,24,4014300,47,25,22
128,21,24,4014400,619,308,311
129,21,24,4014500,391,184,207
130,21,24,4014600,399,198,201
131,21,24,4014700,342,161,181
132,21,24,4014800,300,150,150
133,21,24,4014900,545,271,274
134,21,24,4015000,145,72,73
135,21,24,4015100,1145,566,579
136,21,24,4015200,0,0,0
137,21,24,4015300,533,270,263
138,21,24,4015400,190,97,93
139,21,24,4015500,305,162,143
140,21,24,4015600,691,322,369
141,21,24,4015700,283,140,143
142,21,24,4015800,1212,626,586
143,21,24,4015900,10,10,0
144,21,24,4016000,539,269,270
145,21,24,4016100,1589,798,791
146,21,24,4016200,463,212,251
147,21,24,4016300,232,122,110
148,21,24,4016400,141,72,69
149,21,24,4016500,333,158,175
150,21,24,4016600,326,159,167
151,21,24,4016700,834,423,411
152,21,24,4016800,82,41,41
153,21,24,4016900,483,238,245
154,21,24,4017000,531,261,270
155,21,24,4017100,510,258,252
156,21,24,4017200,470,224,246
157,21,24,4017300,0,0,0
158,21,24,4017400,329,152,177
159,21,24,4017500,795,399,396
160,21,24,4017600,901,451,450
161,21,24,4017700,916,434,482
162,21,24,4017800,436,225,211
163,21,24,4017900,291,140,151
164,21,24,4018000,231,119,112
165,21,24,4018100,543,262,281
166,21,24,4018200,870,406,464
167,21,24,4018300,327,167,160
168,21,24,4018400,680,349,331
169,21,24,4018500,33,15,18
170,21,24,4018600,564,305,259
171,21,24,4018700,205,91,114
172,21,24,4018800,204,100,104
173,21,24,4018900,1289,633,656
174,21,24,4019000,609,308,301
175,21,24,4019100,754,380,374
176,21,24,4019200,156,73,83
177,21,24,4019300,541,285,256
178,21,24,4019400,408,209,199
179,21,24,4019500,340,160,180
180,21,24,4019600,134,71,63
181,21,24,4019700,572,292,280
182,21,24,4019800,78,40,38
183,21,24,4019900,533,272,261
184,21,24,4020000,829,417,412
185,21,24,4020100,348,180,168
186,21,24,4020200,380,184,196
187,21,24,4020300,93,48,45
188,21,24,4020400,138,63,75
189,21,24,4020500,53,29,24
190,21,24,4020600,435,206,229
191,21,24,4020700,618,289,329
192,21,24,4020800,852,416,436
193,21,24,4020900,418,217,201
194,21,24,4021000,682,358,324
195,21,24,4021100,748,361,387
196,21,24,4021200,0,0,0
197,21,24,4021300,525,262,263
198,21,24,4021400,311,157,154
199,21,24,4021500,162,75,87
200,21,24,4021600,463,238,225
201,21,24,4021700,1063,539,524
202,21,24,4021800,143,70,73
203,21,24,4021900,238,123,115
204,21,24,4022000,245,119,126
205,21,24,4022100,208,93,115
206,21,24,4022200,161,81,80
207,21,24,4022300,451,211,240
208,21,24,4022400,146,76,70
209,21,24,4022500,348,177,171
210,21,24,4022600,422,214,208
211,21,24,4022700,435,216,219
212,21,24,4022800,266,126,140
213,21,24,4022900,1109,555,554
214,21,24,4023000,328,171,157
215,21,24,4023100,364,183,181
216,21,24,4023200,162,81,81
217,21,24,4023300,280,142,138
218,21,24,4023400,1383,728,655
219,21,24,4023500,194,96,98
220,21,24,4023600,1008,510,498
221,21,24,4023700,530,266,264
222,21,24,4023800,417,208,209
223,21,24,4023900,156,76,80
224,21,24,4024000,295,145,150
225,21,24,4024100,235,148,87
226,21,24,4024200,269,141,128
227,21,24,4024300,120,57,63
228,21,24,4024400,637,316,321
229,21,24,4024500,539,258,281
230,21,24,4024600,484,227,257
231,21,24,4024700,431,220,211
232,21,24,4024800,526,257,269
233,21,24,4024900,370,195,175
234,21,24,4025000,523,255,268
235,21,24,4025100,1010,542,468
236,21,24,4025200,746,353,393
237,21,24,4025300,400,195,205
238,21,24,4025400,496,232,264
239,21,24,4025500,435,212,223
240,21,24,4025600,318,153,165
241,21,24,4025700,343,156,187
242,21,24,4025800,407,209,198
243,21,24,4025900,476,239,237
244,21,24,4026000,1537,777,760
245,21,24,4026100,949,471,478
246,21,24,4026200,220,102,118
247,21,24,4026300,448,231,217
248,21,24,4026400,0,0,0
249,21,24,4026500,380,204,176
250,21,24,4026600,216,99,117
251,21,24,4026700,486,228,258
252,21,24,4026800,910,427,483
253,21,24,4026900,473,224,249
254,21,24,4027000,164,70,94
255,21,24,4027100,301,136,165
256,21,24,4027200,389,196,193
257,21,24,4027300,716,368,348
258,21,24,4027400,6992,3704,3288
259,21,24,4027500,1660,859,801
260,21,24,4027600,881,424,457
261,21,24,4027700,305,150,155
262,21,24,4027800,452,223,229
263,21,24,4027900,28,11,17
264,21,24,4028000,170,90,80
265,21,24,4028100,700,352,348
266,21,24,4028200,693,349,344
267,21,24,4028300,520,276,244
268,21,24,4028400,1131,545,586
269,21,24,4028500,223,105,118
270,21,24,4028600,1283,651,632
271,21,24,4028700,307,157,150
272,21,24,4028800,1008,498,510
273,21,24,4028900,729,375,354
274,21,24,4029000,876,445,431
275,21,24,4029100,405,214,191
276,21,24,4029200,1029,508,521
277,21,24,4029300,1958,1004,954
278,21,24,4029400,370,184,186
279,21,24,4029500,194,100,94
280,21,24,4029600,364,189,175
281,21,24,4029700,692,340,352
282,21,24,4029800,96,54,42
283,21,24,4029900,449,211,238
284,21,24,4030000,181,83,98
285,21,24,4030100,270,132,138
286,21,24,4030200,165,92,73
287,21,24,4030300,238,114,124
288,21,24,4030400,87,49,38
289,21,24,4030500,800,408,392
290,21,24,4030600,2975,1486,1489
291,21,24,4030700,157,83,74
292,21,24,4030800,1213,645,568
293,21,24,4030900,982,488,494
294,21,24,4031000,797,399,398
295,21,24,4031100,201,94,107
296,21,24,4031200,761,381,380
297,21,24,4031300,415,209,206
298,21,24,4031400,410,201,209
299,21,24,4031500,296,154,142
300,21,24,4031600,688,311,377
301,21,24,4031700,605,298,307
302,21,24,4031800,255,133,122
303,21,24,4031900,311,149,162
304,21,24,4032000,627,294,333
305,21,24,4032100,316,151,165
306,21,24,4032200,626,328,298
307,21,24,4032300,373,178,195
308,21,24,4032400,432,222,210
309,21,24,4032500,959,450,509
310,21,24,4032600,997,476,521
311,21,24,4032700,1185,591,594
312,21,24,4032800,842,418,424
313,21,24,4032900,1149,575,574
314,21,24,4033000,2100,1056,1044
315,21,24,4033100,580,288,292
316,21,24,4033200,759,389,370
317,21,24,4033300,323,158,165
318,21,24,4033400,441,206,235
319,21,24,4033500,671,328,343
320,21,24,4033600,532,253,279
321,21,24,4033700,2481,1213,1268
322,21,24,4033800,491,239,252
323,21,24,4033900,1075,516,559
324,21,24,4034000,639,318,321
325,21,24,4034100,371,187,184
326,21,24,4034200,1030,531,499
327,21,24,4034300,242,114,128
328,21,24,4034400,599,295,304
329,21,24,4034500,439,210,229
330,21,24,4034600,728,363,365
331,21,24,4034700,652,328,324
332,21,24,4034800,417,207,210
333,21,24,4034900,456,211,245
334,21,24,4035000,278,141,137
335,21,24,4035100,606,305,301
336,21,24,4035200,327,149,178
337,21,24,4035300,302,160,142
338,21,24,4035400,367,187,180
339,21,24,4035500,539,278,261
340,21,24,4035600,417,195,222
341,21,24,4035700,584,265,319
342,21,24,4035800,1244,636,608
343,21,24,4035900,357,191,166
344,21,24,4036000,328,173,155
345,21,24,4036100,398,197,201
346,21,24,4036200,1540,781,759
347,21,24,4036300,491,241,250
348,21,24,4036400,306,155,151
349,21,24,4036500,476,241,235
350,21,24,4036600,951,493,458
351,21,24,4036700,212,106,106
352,21,24,4036800,825,444,381
353,21,24,4036900,336,161,175
354,21,24,4037000,398,202,196
355,21,24,4037100,461,226,235
356,21,24,4037200,2287,1174,1113
357,21,24,4037300,675,346,329
358,21,24,4037400,496,249,247
359,21,24,4037500,313,153,160
360,21,24,4037600,303,145,158
361,21,24,4037700,280,149,131
362,21,24,4037800,646,309,337
363,21,24,4037900,152,77,75
364,21,24,4038000,959,470,489
365,21,24,4038100,674,320,354
366,21,24,4038200,545,280,265
367,21,24,4038300,692,358,334
368,21,24,4038400,816,403,413
369,21,24,4038500,140,72,68
370,21,24,4038600,363,169,194
371,21,24,4038700,274,140,134
372,21,24,4038800,803,403,400
373,21,24,4038900,306,158,148
374,21,24,4039000,268,128,140
375,21,24,4039100,243,114,129
376,21,24,4039200,459,226,233
377,21,24,4039300,1392,742,650
378,21,24,4039400,442,217,225
379,21,24,4039500,1223,622,601
380,21,24,4039600,438,214,224
381,21,24,4039700,411,175,236
382,21,24,4039800,431,177,254
383,21,24,4039900,678,354,324
384,21,24,4040000,1491,702,789
385,21,24,4040100,917,450,467
386,21,24,4040200,2546,1274,1272
387,21,24,4040300,233,121,112
388,21,24,4040400,608,316,292
389,21,24,4040500,542,261,281
390,21,24,4040600,4700,2336,2364
391,21,24,4040700,259,124,135
392,21,24,4040800,276,136,140
393,21,24,4040900,529,276,253
394,21,24,4041000,602,296,306
395,21,24,4041100,270,135,135
396,21,24,4041200,151,73,78
397,21,24,4041300,997,515,482
398,21,24,4041400,952,453,499
399,21,24,4041500,188,91,97
400,21,24,4041600,869,434,435
401,21,24,4041700,187,93,94
402,21,24,4041800,1377,708,669
403,21,24,4041900,235,118,117
404,21,24,4042000,833,424,409
405,21,24,4042100,705,340,365
406,21,24,4042200,454,219,235
407,21,24,4042300,735,381,354
408,21,24,4042400,930,453,477
409,21,24,4042500,538,269,269
410,21,24,4042600,736,361,375
411,21,24,4042700,261,126,135
412,21,24,4042800,504,254,250
413,21,24,4042900,140,71,69
414,21,24,4043000,375,185,190
415,21,24,4043100,285,139,146
416,21,24,4043200,211,105,106
417,21,24,4043300,352,190,162
418,21,24,4043400,105,55,50
419,21,24,4043500,750,375,375
420,21,24,4043600,387,184,203
421,21,24,4043700,362,185,177
422,21,24,4043800,641,303,338
423,21,24,4043900,922,463,459
424,21,24,4044000,356,170,186
425,21,24,4044100,34,16,18
426,21,24,4044200,386,194,192
427,21,24,4044300,1032,504,528
428,21,24,4044400,294,133,161
429,21,24,4044500,468,237,231
430,21,24,4044600,1085,542,543
431,21,24,4044700,636,329,307
432,21,24,4044800,308,148,160
433,21,24,4044900,35,14,21
434,21,24,4045000,263,124,139
435,21,24,4045100,455,234,221
436,21,24,4045200,492,241,251
437,21,24,4045300,1079,560,519
438,21,24,4045400,438,218,220
439,21,24,4045500,430,217,213
440,21,24,4045600,140,65,75
441,21,24,4045700,473,214,259
442,21,24,4045800,276,143,133
443,21,24,4045900,1190,616,574
444,21,24,4046000,139,70,69
445,21,24,4046100,492,256,236
446,21,24,4046200,727,356,371
447,21,24,4046300,675,333,342
448,21,24,4046400,321,167,154
449,21,24,4046500,375,177,198
450,21,24,4046600,1065,535,530
451,21,24,4046700,456,219,237
452,21,24,4046800,599,294,305
453,21,24,4046900,655,339,316
454,21,24,4047000,752,375,377
455,21,24,4047100,243,122,121
456,21,24,4047200,529,277,252
457,21,24,4047300,659,315,344
458,21,24,4047400,1322,648,674
459,21,24,4047500,117,58,59
460,21,24,4047600,501,263,238
461,21,24,4047700,1385,697,688
462,21,24,4047800,175,84,91
463,21,24,4047900,351,171,180
464,21,24,4048000,214,107,107
465,21,24,4048100,605,301,304
466,21,24,4048200,399,197,202
467,21,24,4048300,654,323,331
468,21,24,4048400,510,246,264
469,21,24,4048500,543,270,273
470,21,24,4048600,217,98,119
471,21,24,4048700,216,95,121
472,21,24,4048800,286,145,141
473,21,24,4048900,693,350,343
474,21,24,4049000,265,134,131
475,21,24,4049100,298,140,158
476,21,24,4049200,390,198,192
477,21,24,4049300,508,249,259
478,21,24,4049400,302,151,151
479,21,24,4049500,373,182,191
480,21,24,4049600,430,211,219
481,21,24,4049700,809,407,402
482,21,24,4049800,734,375,359
483,21,24,4049900,1016,489,527
484,21,24,4050000,312,161,151
485,21,24,4050100,240,120,120
486,21,24,4050200,613,311,302
487,21,24,4050300,1127,548,579
488,21,24,4050400,360,175,185
489,21,24,4050500,0,0,0
490,21,24,4050600,677,339,338
491,21,24,4050700,320,156,164
492,21,24,4050800,249,118,131
493,21,24,4050900,711,351,360
494,21,24,4051000,1180,605,575
495,21,24,4051100,264,129,135
496,21,24,4051200,1542,765,777
497,21,24,4051300,139,71,68
498,21,24,4051400,416,200,216
499,21,24,4051500,404,199,205
500,21,24,4051600,500,237,263
501,21,24,4051700,350,188,162
502,21,24,4051800,234,126,108
503,21,24,4051900,1212,615,597
504,21,24,4052000,578,281,297
505,21,24,4052100,1080,514,566
506,21,24,4052200,1017,507,510
507,21,24,4052300,226,113,113
508,21,24,4052400,711,342,369
509,21,24,4052500,801,399,402
510,21,24,4052600,1061,527,534
511,21,24,4052700,597,289,308
512,21,24,4052800,1044,530,514
513,21,24,4052900,494,238,256
514,21,24,4053000,724,352,372
515,21,24,4053100,901,439,462
516,21,24,4053200,1130,571,559
517,21,24,4053300,703,369,334
518,21,24,4053400,265,121,144
519,21,24,4053500,337,173,164
520,21,24,4053600,1045,515,530
521,21,24,4053700,253,128,125
522,21,24,4053800,223,110,113
523,21,24,4053900,89,46,43
524,21,24,4054000,4389,2225,2164
525,21,24,4054100,249,129,120
526,21,24,4054200,389,205,184
527,21,24,4054300,310,159,151
528,21,24,4054400,798,376,422
529,21,24,4054500,278,135,143
530,21,24,4054600,1073,522,551
531,21,24,4054700,844,410,434
532,21,24,4054800,383,189,194
533,21,24,4054900,966,481,485
534,21,24,4055000,286,150,136
535,21,24,4055100,815,372,443
536,21,24,4055200,491,242,249
537,21,24,4055300,325,161,164
538,21,24,4055400,144,77,67
539,21,24,4055500,468,226,242
540,21,24,4055600,157,78,79
541,21,24,4055700,551,280,271
542,21,24,4055800,756,358,398
543,21,24,4055900,484,234,250
544,21,24,4056000,171,82,89
545,21,24,4056100,1185,586,599
546,21,24,4056200,754,372,382
547,21,24,4056300,450,221,229
548,21,24,4056400,751,377,374
549,21,24,4056500,614,308,306
550,21,24,4056600,1234,622,612
551,21,24,4056700,1486,759,727
552,21,24,4056800,352,177,175
553,21,24,4056900,317,153,164
554,21,24,4057000,395,194,201
555,21,24,4057100,552,273,279
556,21,24,4057200,387,197,190
557,21,24,4057300,324,154,170
558,21,24,4057400,395,190,205
559,21,24,4057500,2053,999,1054
560,21,24,4057600,856,434,422
561,21,24,4057700,1204,583,621
562,21,24,4057800,1736,860,876
563,21,24,4057900,1337,692,645
564,21,24,4058000,524,269,255
565,21,24,4058100,0,0,0
566,21,24,4058200,502,260,242
567,21,24,4058300,0,0,0
568,21,24,4058400,504,254,250
569,21,24,4058500,156,74,82
570,21,24,4058600,215,103,112
571,21,24,4058700,502,241,261
572,21,24,4058800,121,59,62
573,21,24,4058900,427,200,227
574,21,24,4059000,2353,1157,1196
575,21,24,4059100,0,0,0
576,21,24,4059200,653,351,302
577,21,24,4059300,348,188,160
578,21,24,4059400,223,115,108
579,21,24,4059500,706,354,352
580,21,24,4059600,223,108,115
581,21,24,4059700,657,307,350
582,21,24,4059800,1056,509,547
583,21,24,4059900,235,118,117
584,21,24,4060000,1978,987,991
585,21,24,4060100,526,258,268
586,21,24,4060200,495,239,256
587,21,24,4060300,435,212,223
588,21,24,4060400,272,127,145
589,21,24,4060500,770,392,378
590,21,24,4060600,272,144,128
591,21,24,4060700,809,390,419
592,21,24,4060800,1651,840,811
593,21,24,4060900,985,485,500
594,21,24,4061000,564,292,272
595,21,24,4061100,187,96,91
596,21,24,4061200,1832,893,939
597,21,24,4061300,444,213,231
598,21,24,4061400,669,345,324
599,21,24,4061500,1546,774,772
600,21,24,4061600,1658,833,825
601,21,24,4061700,138,66,72
602,21,24,4061800,420,200,220
603,21,24,4061900,205,107,98
604,21,24,4062000,153,77,76
605,21,24,4062100,467,225,242
606,21,24,4062200,793,407,386
607,21,24,4062300,579,281,298
608,21,24,4062400,1324,652,672
609,21,24,4062500,1158,581,577
610,21,24,4062600,421,200,221
611,21,24,4062700,256,125,131
612,21,24,4062800,486,234,252
613,21,24,4062900,429,208,221
614,21,24,4063000,1068,506,562
615,21,24,4063100,1071,521,550
616,21,24,4063200,300,134,166
617,21,24,4063300,131,59,72
618,21,24,4063400,64,34,30
619,21,24,4063500,1030,516,514
620,21,24,4063600,620,307,313
621,21,24,4063700,774,380,394
622,21,24,4063800,210,109,101
623,21,24,4063900,129,61,68
624,21,24,4064000,302,165,137
625,21,24,4064100,399,183,216
626,21,24,4064200,570,284,286
627,21,24,4064300,248,127,121
628,21,24,4064400,140,70,70
629,21,24,4064500,958,474,484
630,21,24,4064600,138,65,73
631,21,24,4064700,1024,528,496
632,21,24,4064800,1073,547,526
633,21,24,4064900,760,366,394
634,21,24,4065000,234,117,117
635,21,24,4065100,1344,661,683
636,21,24,4065200,1022,508,514
637,21,24,4065300,1220,688,532
638,21,24,4065400,318,159,159
639,21,24,4065500,531,251,280
640,21,24,4065600,524,270,254
641,21,24,4065700,1693,856,837
642,21,24,4065800,684,320,364
643,21,24,4065900,1072,533,539
644,21,24,4066000,774,380,394
645,21,24,4066100,1654,800,854
646,21,24,4066200,1226,603,623
647,21,24,4066300,54,34,20
648,21,24,4066400,1124,566,558
649,21,24,4066500,237,103,134
650,21,24,4066600,465,223,242
651,21,24,4066700,865,429,436
652,21,24,4066800,176,87,89
653,21,24,4066900,2007,998,1009
654,21,24,4067000,25,11,14
655,21,24,4067100,332,164,168
656,21,24,4067200,364,177,187
657,21,24,4067300,502,249,253
658,21,24,4067400,1151,595,556
659,21,24,4067500,554,292,262
660,21,24,4067600,197,96,101
661,21,24,4067700,237,124,113
662,21,24,4067800,410,202,208
663,21,24,4067900,1977,1009,968
664,21,24,4068000,265,127,138
665,21,24,4068100,506,261,245
666,21,24,4068200,545,275,270
667,21,24,4068300,1067,511,556
668,21,24,4068400,1056,513,543
669,21,24,4068500,770,394,376
670,21,24,4068600,1895,942,953
671,21,24,4068700,1760,856,904
672,21,24,4068800,1170,572,598
673,21,24,4068900,378,199,179
674,21,24,4069000,456,235,221
675,21,24,4069100,620,293,327
676,21,24,4069200,653,305,348
677,21,24,4069300,328,162,166
678,21,24,4069400,177,90,87
679,21,24,4069500,157,82,75
680,21,24,4069600,918,462,456
681,21,24,4069700,695,342,353
682,21,24,4069800,509,265,244
683,21,24,4069900,1406,700,706
684,21,24,4070000,559,293,266
685,21,24,4070100,525,256,269
686,21,24,4070200,642,316,326
687,21,24,4070300,381,180,201
688,21,24,4070400,443,206,237
689,21,24,4070500,0,0,0
690,21,24,4070600,2271,1147,1124
691,21,24,4070700,602,300,302
692,21,24,4070800,1261,628,633
693,21,24,4070900,508,247,261
694,21,24,4071000,567,293,274
695,21,24,4071100,61,24,37
696,21,24,4071200,187,101,86
697,21,24,4071300,676,330,346
698,21,24,4071400,311,155,156
699,21,24,4071500,620,327,293
700,21,24,4071600,77,42,35
701,21,24,4071700,205,109,96
702,21,24,4071800,1119,562,557
703,21,24,4071900,189,99,90
704,21,24,4072000,57,28,29
705,21,24,4072100,703,352,351
706,21,24,4072200,206,104,102
707,21,24,4072300,1648,822,826
708,21,24,4072400,227,123,104
709,21,24,4072500,831,425,406
710,21,24,4072600,1018,533,485
711,21,24,4072700,127,67,60
712,21,24,4072800,117,61,56
713,21,24,4072900,701,369,332
714,21,24,4073000,1167,575,592
715,21,24,4073100,209,98,111
716,21,24,4073200,358,176,182
717,21,24,4073300,223,110,113
718,21,24,4073400,63,28,35
719,21,24,4073500,429,222,207
720,21,24,4073600,503,259,244
721,21,24,4073700,758,372,386
722,21,24,4073800,455,221,234
723,21,24,4073900,240,127,113
724,21,24,4074000,85,46,39
725,21,24,4074100,207,88,119
726,21,24,4074200,2364,1174,1190
727,21,24,4074300,623,328,295
728,21,24,4074400,0,0,0
729,21,24,4074500,547,270,277
730,21,24,4074600,0,0,0
731,21,24,4074700,871,439,432
732,21,24,4074800,138,71,67
733,21,24,4074900,187,100,87
734,21,24,4075000,473,235,238
735,21,24,4075100,368,174,194
736,21,24,4075200,99,44,55
737,21,24,4075300,252,124,128
738,21,24,4075400,631,294,337
739,21,24,4075500,370,192,178
740,21,24,4075600,353,178,175
741,21,24,4075700,233,111,122
742,21,24,4075800,410,203,207
743,21,24,4075900,223,109,114
744,21,24,4076000,704,338,366
745,21,24,4076100,447,219,228
746,21,24,4076200,139,70,69
747,21,24,4076300,284,141,143
748,21,24,4076400,544,273,271
749,21,24,4076500,222,124,98
750,21,24,4076600,143,64,79
751,21,24,4076700,737,355,382
752,21,24,4076800,414,218,196
753,21,24,4076900,414,203,211
754,21,24,4077000,369,171,198
755,21,24,4077100,692,356,336
756,21,24,4077200,820,415,405
757,21,24,4077300,457,225,232
758,21,24,4077400,422,228,194
759,21,24,4077500,365,193,172
760,21,24,4077600,377,187,190
761,21,24,4077700,443,233,210
762,21,24,4077800,957,474,483
763,21,24,4077900,169,81,88
764,21,24,4078000,372,188,184
765,21,24,4078100,372,180,192
766,21,24,4078200,176,83,93
767,21,24,4078300,212,99,113
768,21,24,4078400,247,131,116
769,21,24,4078500,269,135,134
770,21,24,4078600,98,56,42
771,21,24,4078700,270,131,139
772,21,24,4078800,1405,694,711
773,21,24,4078900,135,61,74
774,21,24,4079000,136,70,66
775,21,24,4079100,457,243,214
776,21,24,4079200,571,300,271
777,21,24,4079300,531,279,252
778,21,24,4079400,558,280,278
779,21,24,4079500,118,57,61
780,21,24,4079600,478,245,233
781,21,24,4079700,117,52,65
782,21,24,4079800,83,41,42
783,21,24,4079900,352,175,177
784,21,24,4080000,340,177,163
785,21,24,4080100,932,489,443
786,21,24,4080200,667,342,325
787,21,24,4080300,5443,2612,2831
788,21,24,4080400,985,517,468
789,21,24,4080500,63,30,33
790,21,24,4080600,836,422,414
791,21,24,4080700,161,82,79
792,21,24,4080800,380,189,191
793,21,24,4080900,342,187,155
794,21,24,4081000,671,350,321
795,21,24,4081100,1022,525,497
796,21,24,4081200,2279,1141,1138
797,21,24,4081300,670,354,316
798,21,24,4081400,112,61,51
799,21,24,4081500,153,70,83
800,21,24,4081600,460,239,221
801,21,24,4081700,480,239,241
802,21,24,4081800,835,420,415
803,21,24,4081900,1438,735,703
804,21,24,4082000,799,396,403
805,21,24,4082100,205,109,96
806,21,24,4082200,361,187,174
807,21,24,4082300,625,311,314
808,21,24,4082400,1072,548,524
809,21,24,4082500,360,182,178
810,21,24,4082600,274,141,133
811,21,24,4082700,528,258,270
812,21,24,4082800,722,357,365
813,21,24,4082900,929,464,465
814,21,24,4083000,314,162,152
815,21,24,4083100,480,245,235
816,21,24,4083200,678,343,335
817,21,24,4083300,572,293,279
818,21,24,4083400,1229,610,619
819,21,24,4083500,786,379,407
820,21,24,4083600,456,226,230
821,21,24,4083700,299,150,149
822,21,24,4083800,211,104,107
823,21,24,4083900,203,108,95
824,21,24,4084000,56,29,27
825,21,24,4084100,152,75,77
826,21,24,4084200,610,305,305
827,21,24,4084300,188,102,86
828,21,24,4084400,66,36,30
829,21,24,4084500,664,327,337
830,21,24,4084600,274,143,131
831,21,24,4084700,1650,842,808
832,21,24,4084800,972,481,491
833,21,24,4084900,264,135,129
834,21,24,4085000,868,455,413
835,21,24,4085100,390,199,191
836,21,24,4085200,434,216,218
837,21,24,4085300,387,188,199
838,21,24,4085400,347,184,163
839,21,24,4085500,1303,653,650
840,21,24,4085600,183,99,84
841,21,24,4085700,207,117,90
842,21,24,4085800,501,251,250
843,21,24,4085900,323,163,160
844,21,24,4086000,488,254,234
845,21,24,4086100,515,256,259
846,21,24,4086200,331,155,176
847,21,24,4086300,230,106,124
848,21,24,4086400,411,203,208
849,21,24,4086500,441,219,222
850,21,24,4086600,849,434,415
851,21,24,4086700,500,253,247
852,21,24,4086800,978,501,477
853,21,24,4086900,475,237,238
854,21,24,4087000,654,333,321
855,21,24,4087100,375,191,184
856,21,24,4087200,574,284,290
857,21,24,4087300,1576,809,767
858,21,24,4087400,419,225,194
859,21,24,4087500,250,126,124
860,21,24,4087600,997,500,497
861,21,24,4087700,1648,805,843
862,21,24,4087800,396,198,198
863,21,24,4087900,1685,838,847
864,21,24,4088000,389,198,191
865,21,24,4088100,1596,817,779
866,21,24,4088200,522,244,278
867,21,24,4088300,528,265,263
868,21,24,4088400,1244,634,610
869,21,24,4088500,0,0,0
870,21,24,4088600,0,0,0
871,21,24,4088700,0,0,0
872,21,24,4088800,445,209,236
873,21,24,4088900,393,206,187
874,21,24,4089000,522,271,251
875,21,24,4089100,1158,576,582
876,21,24,4089200,406,202,204
877,21,24,4089300,1055,544,511
878,21,24,4089400,488,246,242
879,21,24,4089500,645,330,315
880,21,24,4089600,1547,789,758
881,21,24,4089700,2308,1170,1138
882,21,24,4089800,786,393,393
883,21,24,4089900,227,120,107
884,21,24,4090000,216,112,104
885,21,24,4090100,719,347,372
886,21,24,4090200,684,333,351
887,21,24,4090300,505,252,253
888,21,24,4090400,666,328,338
889,21,24,4090500,4822,2794,2028
890,21,24,4090600,326,152,174
891,21,24,4090700,133,69,64
892,21,24,4090800,672,343,329
893,21,24,4090900,449,216,233
894,21,24,4091000,202,93,109
895,21,24,4091100,688,332,356
896,21,24,4091200,417,212,205
897,21,24,4091300,837,434,403
898,21,24,4091400,673,337,336
899,21,24,4091500,595,308,287
900,21,24,4091600,2384,1222,1162
901,21,24,4091700,989,491,498
902,21,24,4091800,286,150,136
903,21,24,4091900,498,254,244
904,21,24,4092000,2394,1220,1174
905,21,24,4092100,425,212,213
906,21,24,4092200,517,247,270
907,21,24,4092300,519,248,271
908,21,24,4092400,245,131,114
909,21,24,4092500,621,320,301
910,21,24,4092600,707,333,374
911,21,24,4092700,474,245,229
912,21,24,4092800,199,105,94
913,21,24,4092900,0,0,0
914,21,24,4093000,2991,1515,1476
915,21,24,4093100,281,143,138
916,21,24,4093200,654,332,322
917,21,24,4093300,361,178,183
918,21,24,4093400,1110,536,574
919,21,24,4093500,785,387,398
920,21,24,4093600,316,152,164
921,21,24,4093700,489,256,233
922,21,24,4093800,334,174,160
923,21,24,4093900,300,152,148
924,21,24,4094000,138,69,69
925,21,24,4094100,1244,625,619
926,21,24,4094200,201,104,97
927,21,24,4094300,774,382,392
928,21,24,4094400,374,186,188
929,21,24,4094500,1345,683,662
930,21,24,4094600,1027,528,499
931,21,24,4094700,577,289,288
932,21,24,4094800,642,323,319
933,21,24,4094900,487,234,253
934,21,24,4095000,403,210,193
935,21,24,4095100,667,290,377
936,21,24,4095200,0,0,0
937,21,24,4095300,488,244,244
938,21,24,4095400,294,143,151
939,21,24,4095500,553,275,278
940,21,24,4095600,889,445,444
941,21,24,4095700,501,242,259
942,21,24,4095800,435,218,217
943,21,24,4095900,596,292,304
944,21,24,4096000,651,312,339
945,21,24,4096100,591,296,295
946,21,24,4096200,253,130,123
947,21,24,4096300,881,456,425
948,21,24,4096400,556,246,310
949,21,24,4096500,1470,760,710
950,21,24,4096600,496,253,243
951,21,24,4096700,1813,902,911
952,21,24,4096800,485,244,241
953,21,24,4096900,131,71,60
954,21,24,4097000,213,102,111
955,21,24,4097100,482,254,228
956,21,24,4097200,384,205,179
957,21,24,4097300,430,225,205
958,21,24,4097400,293,144,149
959,21,24,4097500,0,0,0
960,21,24,4097600,862,418,444
961,21,24,4097700,238,118,120
962,21,24,4097800,363,192,171
963,21,24,4097900,301,158,143
964,21,24,4098000,1247,634,613
965,21,24,4098100,737,356,381
966,21,24,4098200,284,148,136
967,21,24,4098300,260,131,129
968,21,24,4098400,234,107,127
969,21,24,4098500,397,202,195
970,21,24,4098600,302,156,146
971,21,24,4098700,302,154,148
972,21,24,4098800,423,215,208
973,21,24,4098900,383,181,202
974,21,24,4099000,0,0,0
975,21,24,4099100,683,331,352
976,21,24,4099200,258,129,129
977,21,24,4099300,384,196,188
978,21,24,4099400,703,357,346
979,21,24,4099500,892,441,451
980,21,24,4099600,88,42,46
981,21,24,4099700,149,63,86
982,21,24,4099800,846,432,414
983,21,24,4099900,317,164,153
984,21,24,4100000,87,44,43
985,21,24,4100100,409,201,208
986,21,24,4100200,187,91,96
987,21,24,4100300,576,283,293
988,21,24,4100400,1386,697,689
989,21,24,4100500,997,504,493
990,21,24,4100600,175,100,75
991,21,24,4100700,223,121,102
992,21,24,4100800,1173,598,575
993,21,24,4100900,223,116,107
994,21,24,4101000,1361,700,661
995,21,24,4101100,897,457,440
996,21,24,4101200,784,380,404
997,21,24,4101300,444,221,223
998,21,24,4101400,566,287,279
999,21,24,4101500,426,218,208
1000,21,24,4101600,583,295,288
1001,21,24,4101700,444,223,221
1002,21,24,4101800,325,164,161
1003,21,24,4101900,577,297,280
1004,21,24,4102000,711,365,346
1005,21,24,4102100,245,120,125
1006,21,24,4102200,552,277,275
1007,21,24,4102300,435,214,221
1008,21,24,4102400,415,205,210
1009,21,24,4102500,788,395,393
1010,21,24,4102600,621,317,304
1011,21,24,4102700,345,178,167
1012,21,24,4102800,504,238,266
1013,21,24,4102900,471,235,236
1014,21,24,4103000,431,215,216
1015,21,24,4103100,637,315,322
1016,21,24,4103200,799,387,412
1017,21,24,4103300,616,312,304
1018,21,24,4103400,260,138,122
1019,21,24,4103500,941,469,472
1020,21,24,4103600,160,82,78
1021,21,24,4103700,186,94,92
1022,21,24,4103800,1759,894,865
1023,21,24,4103900,982,504,478
1024,21,24,4104000,744,369,375
1025,21,24,4104100,947,507,440
1026,21,24,4104200,383,186,197
1027,21,24,4104300,1019,523,496
1028,21,24,4104400,492,267,225
1029,21,24,4104500,2310,1141,1169
1030,21,24,4104600,1772,927,845
1031,21,24,4104700,805,429,376
1032,21,24,4104800,963,492,471
1033,21,24,4104900,570,296,274
1034,21,24,4105000,2233,1114,1119
1035,21,24,4105100,379,193,186
1036,21,24,4105200,1110,557,553
1037,21,24,4105300,847,446,401
1038,21,24,4105400,680,337,343
1039,21,24,4105500,651,319,332
1040,21,24,4105600,415,212,203
1041,21,24,4105700,450,203,247
1042,21,24,4105800,208,110,98
1043,21,24,4105900,548,273,275
1044,21,24,4106000,1058,537,521
1045,21,24,4106100,201,102,99
1046,21,24,4106200,432,216,216
1047,21,24,4106300,399,205,194
1048,21,24,4106400,600,288,312
1049,21,24,4106500,817,387,430
1050,21,24,4106600,258,133,125
1051,21,24,4106700,681,338,343
1052,21,24,4106800,278,146,132
1053,21,24,4106900,378,178,200
1054,21,24,4107000,273,134,139
1055,21,24,4107100,1973,997,976
1056,21,24,4107200,1253,620,633
1057,21,24,4107300,361,175,186
1058,21,24,4107400,694,347,347
1059,21,24,4107500,587,300,287
1060,21,24,4107600,254,131,123
1061,21,24,4107700,633,328,305
1062,21,24,4107800,460,225,235
1063,21,24,4107900,202,105,97
1064,21,24,4108000,883,435,448
1065,21,24,4108100,304,157,147
1066,21,24,4108200,974,493,481
1067,21,24,4108300,240,123,117
1068,21,24,4108400,880,432,448
1069,21,24,4108500,701,362,339
1070,21,24,4108600,1605,830,775
1071,21,24,4108700,443,238,205
1072,21,24,4108800,495,244,251
1073,21,24,4108900,481,244,237
1074,21,24,4109000,407,198,209
1075,21,24,4109100,727,364,363
1076,21,24,4109200,118,61,57
1077,21,24,4109300,488,255,233
1078,21,24,4109400,2137,1093,1044
1079,21,24,4109500,530,268,262
1080,21,24,4109600,352,165,187
1081,21,24,4109700,923,537,386
1082,21,24,4109800,3988,2100,1888
1083,21,24,4109900,1047,518,529
1084,21,24,4110000,317,154,163
1085,21,24,4110100,226,116,110
1086,21,24,4110200,87,46,41
1087,21,24,4110300,269,138,131
1088,21,24,4110400,1154,570,584
1089,21,24,4110500,406,192,214
1090,21,24,4110600,641,321,320
1091,21,24,4110700,361,176,185
1092,21,24,4110800,617,298,319
1093,21,24,4110900,451,229,222
1094,21,24,4111000,293,151,142
1095,21,24,4111100,816,423,393
1096,21,24,4111200,381,187,194
1097,21,24,4111300,316,149,167
1098,21,24,4111400,316,151,165
1099,21,24,4111500,221,106,115
1100,21,24,4111600,803,402,401
1101,21,24,4111700,472,231,241
1102,21,24,4111800,539,271,268
1103,21,24,4111900,748,376,372
1104,21,24,4112000,593,286,307
1105,21,24,4112100,380,186,194
1106,21,24,4112200,715,361,354
1107,21,24,4112300,328,163,165
1108,21,24,4112400,819,415,404
1109,21,24,4112500,2088,1037,1051
1110,21,24,4112600,571,281,290
1111,21,24,4112700,1174,602,572
1112,21,24,4112800,1602,812,790
1113,21,24,4112900,250,123,127
1114,21,24,4113000,800,404,396
1115,21,24,4113100,473,245,228
1116,21,24,4113200,544,284,260
1117,21,24,4113300,211,99,112
1118,21,24,4113400,567,282,285
1119,21,24,4113500,393,199,194
1120,21,24,4113600,528,252,276
1121,21,24,4113700,372,186,186
1122,21,24,4113800,103,53,50
1123,21,24,4113900,96,46,50
1124,21,24,4114000,868,454,414
1125,21,24,4114100,1088,548,540
1126,21,24,4114200,486,236,250
1127,21,24,4114300,433,223,210
1128,21,24,4114400,0,0,0
1129,21,24,4114500,232,120,112
1130,21,24,4114600,1514,784,730
1131,21,24,4114700,415,196,219
1132,21,24,4114800,491,252,239
1133,21,24,4114900,150,70,80
1134,21,24,4115000,442,219,223
1135,21,24,4115100,293,149,144
1136,21,24,4115200,125,65,60
1137,21,24,4115300,131,63,68
1138,21,24,4115400,205,106,99
1139,21,24,4115500,251,122,129
1140,21,24,4115600,211,109,102
1141,21,24,4115700,281,141,140
1142,21,24,4115800,335,172,163
1143,21,24,4115900,210,97,113
1144,21,24,4116000,307,154,153
1145,21,24,4116100,123,61,62
1146,21,24,4116200,148,74,74
1147,21,24,4116300,54,26,28
1148,21,24,4116400,111,50,61
1149,21,24,4116500,335,207,128
1150,21,24,4116600,214,99,115
1151,21,24,4116700,192,95,97
1152,21,24,4116800,246,131,115
1153,21,24,4116900,331,174,157
1154,21,24,4117000,0,0,0
1155,21,24,4117100,96,43,53
1156,21,24,4117200,202,94,108
1157,21,24,4117300,1517,761,756
1158,21,24,4117400,158,84,74
1159,21,24,4117500,322,162,160
1160,21,24,4117600,274,137,137
1161,21,24,4117700,434,210,224
1162,21,24,4117800,419,200,219
1163,21,24,4117900,264,130,134
1164,21,24,4118000,310,150,160
1165,21,24,4118100,157,81,76
1166,21,24,4118200,1279,645,634
1167,21,24,4118300,1058,508,550
1168,21,24,4118400,352,176,176
1169,21,24,4118500,217,113,104
1170,21,24,4118600,224,114,110
1171,21,24,4118700,244,117,127
1172,21,24,4118800,68,35,33
1173,21,24,4118900,166,82,84
1174,21,24,4119000,356,179,177
1175,21,24,4119100,848,406,442
1176,21,24,4119200,202,101,101
1177,21,24,4119300,2597,1286,1311
1178,21,24,4119400,907,469,438
1179,21,24,4119500,684,340,344
1180,21,24,4119600,380,190,190
1181,21,24,4119700,144,69,75
1182,21,24,4119800,557,276,281
1183,21,24,4119900,324,163,161
1184,21,24,4120000,146,70,76
1185,21,24,4120100,296,148,148
1186,21,24,4120200,240,111,129
1187,21,24,4120300,183,93,90
1188,21,24,4120400,269,139,130
1189,21,24,4120500,263,129,134
1190,21,24,4120600,633,311,322
1191,21,24,4120700,340,164,176
1192,21,24,4120800,1178,586,592
1193,21,24,4120900,840,434,406
1194,21,24,4121000,1255,620,635
1195,21,24,4121100,602,303,299
1196,21,24,4121200,1000,486,514
1197,21,24,4121300,834,420,414
1198,21,24,4121400,293,152,141
1199,21,24,4121500,413,206,207
1200,21,24,4121600,227,112,115
1201,21,24,4121700,491,248,243
1202,21,24,4121800,840,434,406
1203,21,24,4121900,496,263,233
1204,21,24,4122000,207,99,108
1205,21,24,4122100,363,187,176
1206,21,24,4122200,75,34,41
1207,21,24,4122300,340,170,170
1208,21,24,4122400,119,58,61
1209,21,24,4122500,117,58,59
1210,21,24,4122600,820,408,412
1211,21,24,4122700,187,87,100
1212,21,24,4122800,468,220,248
1213,21,24,4122900,307,152,155
1214,21,24,4123000,305,156,149
1215,21,24,4123100,316,154,162
1216,21,24,4123200,1438,704,734
1217,21,24,4123300,447,237,210
1218,21,24,4123400,232,119,113
1219,21,24,4123500,633,335,298
1220,21,24,4123600,166,89,77
1221,21,24,4123700,196,107,89
1222,21,24,4123800,154,71,83
1223,21,24,4123900,66,32,34
1224,21,24,4124000,229,121,108
1225,21,24,4124100,194,93,101
1226,21,24,4124200,578,290,288
1227,21,24,4124300,321,171,150
1228,21,24,4124400,82,42,40
1229,21,24,4124500,282,136,146
1230,21,24,4124600,140,64,76
1231,21,24,4124700,469,242,227
1232,21,24,4124800,418,197,221
1233,21,24,4124900,331,168,163
1234,21,24,4125000,276,135,141
1235,21,24,4125100,159,75,84
1236,21,24,4125200,469,236,233
1237,21,24,4125300,927,462,465
1238,21,24,4125400,275,135,140
1239,21,24,4125500,762,380,382
1240,21,24,4125600,319,159,160
1241,21,24,4125700,269,144,125
1242,21,24,4125800,812,394,418
1243,21,24,4125900,1254,632,622
1244,21,24,4126000,764,392,372
1245,21,24,4126100,180,89,91
1246,21,24,4126200,578,292,286
1247,21,24,4126300,155,71,84
1248,21,24,4126400,2016,995,1021
1249,21,24,4126500,356,164,192
1250,21,24,4126600,572,286,286
1251,21,24,4126700,806,406,400
1252,21,24,4126800,396,204,192
1253,21,24,4126900,46,22,24
1254,21,24,4127000,734,363,371
1255,21,24,4127100,799,418,381
1256,21,24,4127200,1030,545,485
1257,21,24,4127300,469,231,238
1258,21,24,4127400,436,214,222
1259,21,24,4127500,263,125,138
1260,21,24,4127600,558,280,278
1261,21,24,4127700,164,79,85
1262,21,24,4127800,576,282,294
1263,21,24,4127900,577,272,305
1264,21,24,4128000,657,336,321
1265,21,24,4128100,333,165,168
1266,21,24,4128200,1558,802,756
1267,21,24,4128300,447,232,215
1268,21,24,4128400,328,151,177
1269,21,24,4128500,1504,751,753
1270,21,24,4128600,1252,631,621
1271,21,24,4128700,574,295,279
1272,21,24,4128800,333,165,168
1273,21,24,4128900,1135,585,550
1274,21,24,4129000,738,383,355
1275,21,24,4129100,167,75,92
1276,21,24,4129200,1737,880,857
1277,21,24,4129300,62,26,36
1278,21,24,4129400,1759,878,881
1279,21,24,4129500,374,187,187
1280,21,24,4129600,433,221,212
1281,21,24,4129700,541,279,262
1282,21,24,4129800,504,247,257
1283,21,24,4129900,1461,747,714
1284,21,24,4130000,1195,605,590
1285,21,24,4130100,382,199,183
1286,21,24,4130200,245,119,126
1287,21,24,4130300,560,270,290
1288,21,24,4130400,379,186,193
1289,21,24,4130500,147,68,79
1290,21,24,4130600,358,187,171
1291,21,24,4130700,919,438,481
1292,21,24,4130800,497,257,240
1293,21,24,4130900,881,434,447
1294,21,24,4131000,293,141,152
1295,21,24,4131100,615,308,307
1296,21,24,4131200,563,288,275
1297,21,24,4131300,203,95,108
1298,21,24,4131400,319,158,161
1299,21,24,4131500,263,124,139
1300,21,24,4131600,3536,1817,1719
1301,21,24,4131700,134,72,62
1302,21,24,4131800,901,457,444
1303,21,24,4131900,134,74,60
1304,21,24,4132000,597,293,304
1305,21,24,4132100,475,256,219
1306,21,24,4132200,336,176,160
1307,21,24,4132300,1013,514,499
1308,21,24,4132400,617,313,304
1309,21,24,4132500,746,372,374
1310,21,24,4132600,375,199,176
1311,21,24,4132700,1012,508,504
1312,21,24,4132800,924,470,454
1313,21,24,4132900,305,152,153
1314,21,24,4133000,92,47,45
1315,21,24,4133100,230,118,112
1316,21,24,4133200,532,263,269
1317,21,24,4133300,332,166,166
1318,21,24,4133400,372,183,189
1319,21,24,4133500,614,322,292
1320,21,24,4133600,331,173,158
1321,21,24,4133700,426,203,223
1322,21,24,4133800,583,283,300
1323,21,24,4133900,395,193,202
1324,21,24,4134000,159,77,82
1325,21,24,4134100,167,90,77
1326,21,24,4134200,578,292,286
1327,21,24,4134300,451,217,234
1328,21,24,4134400,305,153,152
1329,21,24,4134500,377,180,197
1330,21,24,4134600,310,150,160
1331,21,24,4134700,710,359,351
1332,21,24,4134800,578,277,301
1333,21,24,4134900,356,178,178
1334,21,24,4135000,581,298,283
1335,21,24,4135100,221,108,113
1336,21,24,4135200,303,163,140
1337,21,24,4135300,1064,532,532
1338,21,24,4135400,522,256,266
1339,21,24,4135500,455,234,221
1340,21,24,4135600,352,182,170
1341,21,24,4135700,381,183,198
1342,21,24,4135800,643,330,313
1343,21,24,4135900,495,234,261
1344,21,24,4136000,547,282,265
1345,21,24,4136100,537,268,269
1346,21,24,4136200,294,136,158
1347,21,24,4136300,447,216,231
1348,21,24,4136400,365,185,180
1349,21,24,4136500,235,117,118
1350,21,24,4136600,424,221,203
1351,21,24,4136700,831,402,429
1352,21,24,4136800,621,291,330
1353,21,24,4136900,603,311,292
1354,21,24,4137000,739,361,378
1355,21,24,4137100,469,227,242
1356,21,24,4137200,611,303,308
1357,21,24,4137300,116,65,51
1358,21,24,4137400,773,401,372
1359,21,24,4137500,2624,1327,1297
1360,21,24,4137600,718,368,350
1361,21,24,4137700,30,13,17
1362,21,24,4137800,875,438,437
1363,21,24,4137900,2430,1214,1216
1364,21,24,4138000,393,201,192
1365,21,24,4138100,1128,573,555
1366,21,24,4138200,47,27,20
1367,21,24,4138300,127,59,68
1368,21,24,4138400,344,168,176
1369,21,24,4138500,361,179,182
1370,21,24,4138600,503,252,251
1371,21,24,4138700,0,0,0
1372,21,24,4138800,699,337,362
1373,21,24,4138900,507,269,238
1374,21,24,4139000,340,170,170
1375,21,24,4139100,783,388,395
1376,21,24,4139200,1320,655,665
1377,21,24,4139300,1779,893,886
1378,21,24,4139400,868,426,442
1379,21,24,4139500,1222,604,618
1380,21,24,4139600,859,440,419
1381,21,24,4139700,655,342,313
1382,21,24,4139800,255,129,126
1383,21,24,4139900,586,293,293
1384,21,24,4140000,256,128,128
1385,21,24,4140100,2024,1030,994
1386,21,24,4140200,583,289,294
1387,21,24,4140300,537,294,243
1388,21,24,4140400,597,285,312
1389,21,24,4140500,637,325,312
1390,21,24,4140600,273,137,136
1391,21,24,4140700,159,83,76
1392,21,24,4140800,108,56,52
1393,21,24,4140900,546,293,253
1394,21,24,4141000,335,161,174
1395,21,24,4141100,187,97,90
1396,21,24,4141200,1097,552,545
1397,21,24,4141300,1007,492,515
1398,21,24,4141400,105,52,53
1399,21,24,4141500,709,353,356
1400,21,24,4141600,778,382,396
1401,21,24,4141700,352,173,179
1402,21,24,4141800,706,364,342
1403,21,24,4141900,394,200,194
1404,21,24,4142000,217,107,110
1405,21,24,4142100,975,488,487
1406,21,24,4142200,387,169,218
1407,21,24,4142300,516,259,257
1408,21,24,4142400,731,367,364
1409,21,24,4142500,657,346,311
1410,21,24,4142600,1403,701,702
1411,21,24,4142700,327,163,164
1412,21,24,4142800,429,209,220
1413,21,24,4142900,1067,566,501
1414,21,24,4143000,2298,1194,1104
1415,21,24,4143100,1069,541,528
1416,21,24,4143200,942,464,478
1417,21,24,4143300,532,264,268
1418,21,24,4143400,588,295,293
1419,21,24,4143500,481,242,239
1420,21,24,4143600,1502,768,734
1421,21,24,4143700,1173,612,561
1422,21,24,4143800,856,433,423
1423,21,24,4143900,650,331,319
1424,21,24,4144000,403,209,194
1425,21,24,4144100,1778,935,843
1426,21,24,4144200,780,396,384
1427,21,24,4144300,2010,976,1034
1428,21,24,4144400,672,342,330
1429,21,24,4144500,742,378,364
1430,21,24,4144600,890,442,448
1431,21,24,4144700,1051,542,509
1432,21,24,4144800,368,184,184
1433,21,24,4144900,313,164,149
1434,21,24,4145000,421,211,210
1435,21,24,4145100,828,400,428
1436,21,24,4145200,817,429,388
1437,21,24,4145300,469,227,242
1438,21,24,4145400,419,234,185
1439,21,24,4145500,232,110,122
1440,21,24,4145600,1802,938,864
1441,21,24,4145700,559,301,258
1442,21,24,4145800,792,381,411
1443,21,24,4145900,1577,780,797
1444,21,24,4146000,381,202,179
1445,21,24,4146100,553,270,283
1446,21,24,4146200,680,337,343
1447,21,24,4146300,1212,596,616
1448,21,24,4146400,592,304,288
1449,21,24,4146500,699,361,338
1450,21,24,4146600,764,372,392
1451,21,24,4146700,617,315,302
1452,21,24,4146800,175,80,95
1453,21,24,4146900,532,278,254
1454,21,24,4147000,455,243,212
1455,21,24,4147100,451,230,221
1456,21,24,4147200,544,274,270
1457,21,24,4147300,457,218,239
1458,21,24,4147400,469,235,234
1459,21,24,4147500,255,129,126
1460,21,24,4147600,575,281,294
1461,21,24,4147700,561,281,280
1462,21,24,4147800,647,330,317
1463,21,24,4147900,283,147,136
1464,21,24,4148000,1224,630,594
1465,21,24,4148100,584,293,291
1466,21,24,4148200,83,38,45
1467,21,24,4148300,249,125,124
1468,21,24,4148400,299,166,133
1469,21,24,4148500,1132,575,557
1470,21,24,4148600,501,266,235
1471,21,24,4148700,275,135,140
1472,21,24,4148800,1017,536,481
1473,21,24,4148900,599,308,291
1474,21,24,4149000,409,213,196
1475,21,24,4149100,931,472,459
1476,21,24,4149200,433,234,199
1477,21,24,4149300,710,353,357
1478,21,24,4149400,201,99,102
1479,21,24,4149500,391,188,203
1480,21,24,4149600,834,420,414
1481,21,24,4149700,507,248,259
1482,21,24,4149800,519,261,258
1483,21,24,4149900,622,299,323
1484,21,24,4150000,228,105,123
1485,21,24,4150100,404,216,188
1486,21,24,4150200,284,135,149
1487,21,24,4150300,458,236,222
1488,21,24,4150400,375,180,195
1489,21,24,4150500,648,333,315
1490,21,24,4150600,766,378,388
1491,21,24,4150700,429,216,213
1492,21,24,4150800,305,151,154
1493,21,24,4150900,1259,622,637
1494,21,24,4151000,191,98,93
1495,21,24,4151100,352,187,165
1496,21,24,4151200,293,152,141
1497,21,24,4151300,259,129,130
1498,21,24,4151400,404,202,202
1499,21,24,4151500,422,209,213
1500,21,24,4151600,260,140,120
1501,21,24,4151700,1033,541,492
1502,21,24,4151800,897,464,433
1503,21,24,4151900,796,397,399
1504,21,24,4152000,655,333,322
1505,21,24,4152100,706,352,354
1506,21,24,4152200,1642,852,790
1507,21,24,4152300,1365,695,670
1508,21,24,4152400,389,190,199
1509,21,24,4152500,262,128,134
1510,21,24,4152600,2048,1053,995
1511,21,24,4152700,1804,943,861
1512,21,24,4152800,1332,673,659
1513,21,24,4152900,620,318,302
1514,21,24,4153000,1344,684,660
1515,21,24,4153100,20,11,9
1516,21,24,4153200,665,330,335
1517,21,24,4153300,447,213,234
1518,21,24,4153400,308,151,157
1519,21,24,4153500,985,509,476
1520,21,24,4153600,0,0,0
1521,21,24,4153700,451,246,205
1522,21,24,4153800,610,326,284
1523,21,24,4153900,399,190,209
1524,21,24,4154000,461,238,223
1525,21,24,4154100,749,369,380
1526,21,24,4154200,482,238,244
1527,21,24,4154300,688,352,336
1528,21,24,4154400,273,129,144
1529,21,24,4154500,619,310,309
1530,21,24,4154600,324,184,140
1531,21,24,4154700,269,135,134
1532,21,24,4154800,280,129,151
1533,21,24,4154900,695,357,338
1534,21,24,4155000,294,153,141
1535,21,24,4155100,341,176,165
1536,21,24,4155200,686,358,328
1537,21,24,4155300,549,273,276
1538,21,24,4155400,624,307,317
1539,21,24,4155500,195,95,100
1540,21,24,4155600,215,109,106
1541,21,24,4155700,362,187,175
1542,21,24,4155800,0,0,0
1543,21,24,4155900,713,367,346
1544,21,24,4156000,578,279,299
1545,21,24,4156100,2301,1175,1126
1546,21,24,4156200,114,57,57
1547,21,24,4156300,839,431,408
1548,21,24,4156400,510,258,252
1549,21,24,4156500,375,181,194
1550,21,24,4156600,318,163,155
1551,21,24,4156700,227,115,112
1552,21,24,4156800,167,85,82
1553,21,24,4156900,272,133,139
1554,21,24,4157000,974,516,458
1555,21,24,4157100,658,328,330
1556,21,24,4157200,557,266,291
1557,21,24,4157300,950,484,466
1558,21,24,4157400,1987,1020,967
1559,21,24,4157500,223,108,115
1560,21,24,4157600,480,233,247
1561,21,24,4157700,731,352,379
1562,21,24,4157800,938,465,473
1563,21,24,4157900,455,234,221
1564,21,24,4158000,538,269,269
1565,21,24,4158100,866,444,422
1566,21,24,4158200,586,289,297
1567,21,24,4158300,0,0,0
1568,21,24,4158400,549,287,262
1569,21,24,4158500,1684,867,817
1570,21,24,4158600,350,178,172
1571,21,24,4158700,535,265,270
1572,21,24,4158800,561,290,271
1573,21,24,4158900,1645,853,792
1574,21,24,4159000,539,277,262
1575,21,24,4159100,128,65,63
1576,21,24,4159200,753,376,377
1577,21,24,4159300,252,131,121
1578,21,24,4159400,328,154,174
1579,21,24,4159500,1106,564,542
1580,21,24,4159600,283,147,136
1581,21,24,4159700,305,148,157
1582,21,24,4159800,669,335,334
1583,21,24,4159900,297,160,137
1584,21,24,4160000,727,363,364
1585,21,24,4160100,210,102,108
1586,21,24,4160200,241,124,117
1587,21,24,4160300,669,329,340
1588,21,24,4160400,278,145,133
1589,21,24,4160500,608,307,301
1590,21,24,4160600,287,149,138
1591,21,24,4160700,345,173,172
1592,21,24,4160800,1279,644,635
1593,21,24,4160900,543,275,268
1594,21,24,4161000,557,290,267
1595,21,24,4161100,488,248,240
1596,21,24,4161200,1032,525,507
1597,21,24,4161300,371,193,178
1598,21,24,4161400,717,354,363
1599,21,24,4161500,199,105,94
1600,21,24,4161600,430,231,199
1601,21,24,4161700,1442,759,683
1602,21,24,4161800,465,236,229
1603,21,24,4161900,461,241,220
1604,21,24,4162000,575,291,284
1605,21,24,4162100,534,261,273
1606,21,24,4162200,236,121,115
1607,21,24,4162300,150,81,69
1608,21,24,4162400,474,224,250
1609,21,24,4162500,187,96,91
1610,21,24,4162600,395,199,196
1611,21,24,4162700,346,176,170
1612,21,24,4162800,63,33,30
1613,21,24,4162900,52,24,28
1614,21,24,4163000,475,244,231
1615,21,24,4163100,735,355,380
1616,21,24,4163200,1330,661,669
1617,21,24,4163300,335,165,170
1618,21,24,4163400,511,264,247
1619,21,24,4163500,295,150,145
1620,21,24,4163600,328,169,159
1621,21,24,4163700,212,110,102
1622,21,24,4163800,2218,1152,1066
1623,21,24,4163900,646,329,317
1624,21,24,4164000,243,119,124
1625,21,24,4164100,1027,517,510
1626,21,24,4164200,647,318,329
1627,21,24,4164300,680,340,340
1628,21,24,4164400,277,140,137
1629,21,24,4164500,337,167,170
1630,21,24,4164600,477,239,238
1631,21,24,4164700,812,397,415
1632,21,24,4164800,574,255,319
1633,21,24,4164900,278,131,147
1634,21,24,4165000,405,199,206
1635,21,24,4165100,325,154,171
1636,21,24,4165200,774,374,400
1637,21,24,4165300,366,179,187
1638,21,24,4165400,1498,748,750
1639,21,24,4165500,456,215,241
1640,21,24,4165600,1035,539,496
1641,21,24,4165700,485,244,241
1642,21,24,4165800,522,263,259
1643,21,24,4165900,648,327,321
1644,21,24,4166000,1818,898,920
1645,21,24,4166100,758,376,382
1646,21,24,4166200,304,167,137
1647,21,24,4166300,509,267,242
1648,21,24,4166400,645,323,322
1649,21,24,4166500,312,155,157
1650,21,24,4166600,1002,494,508
1651,21,24,4166700,1327,665,662
1652,21,24,4166800,571,277,294
1653,21,24,4166900,414,213,201
1654,21,24,4167000,221,117,104
1655,21,24,4167100,1627,799,828
1656,21,24,4167200,3650,1838,1812
1657,21,24,4167300,583,293,290
1658,21,24,4167400,346,189,157
1659,21,24,4167500,1077,534,543
1660,21,24,4167600,937,462,475
1661,21,24,4167700,503,261,242
1662,21,24,4167800,1386,709,677
1663,21,24,4167900,473,233,240
1664,21,24,4168000,599,310,289
1665,21,24,4168100,177,90,87
1666,21,24,4168200,2172,1075,1097
1667,21,24,4168300,637,316,321
1668,21,24,4168400,444,237,207
1669,21,24,4168500,551,278,273
1670,21,24,4168600,350,186,164
1671,21,24,4168700,303,152,151
1672,21,24,4168800,270,137,133
1673,21,24,4168900,199,97,102
1674,21,24,4169000,618,308,310
1675,21,24,4169100,2222,1127,1095
1676,21,24,4169200,417,223,194
1677,21,24,4169300,715,365,350
1678,21,24,4169400,357,187,170
1679,21,24,4169500,1163,577,586
1680,21,24,4169600,0,0,0
1681,21,24,4169700,201,98,103
1682,21,24,4169800,1520,766,754
1683,21,24,4169900,934,469,465
1684,21,24,4170000,2830,1406,1424
1685,21,24,4170100,288,143,145
1686,21,24,4170200,569,273,296
1687,21,24,4170300,638,311,327
1688,21,24,4170400,794,412,382
1689,21,24,4170500,638,316,322
1690,21,24,4170600,111,60,51
1691,21,24,4170700,3251,1639,1612
1692,21,24,4170800,407,204,203
1693,21,24,4170900,1760,862,898
1694,21,24,4171000,347,177,170
1695,21,24,4171100,453,240,213
1696,21,24,4171200,1012,506,506
1697,21,24,4171300,568,277,291
1698,21,24,4171400,2747,1374,1373
1699,21,24,4171500,1040,516,524
1700,21,24,4171600,633,345,288
1701,21,24,4171700,782,393,389
1702,21,24,4171800,2198,1103,1095
1703,21,24,4171900,0,0,0
1704,21,24,4172000,404,213,191
1705,21,24,4172100,727,350,377
1706,21,24,4172200,1018,510,508
1707,21,24,4172300,715,349,366
1708,21,24,4172400,0,0,0
1709,21,24,4172500,0,0,0
1710,21,24,4172600,586,298,288
1711,21,24,4172700,151,78,73
1712,21,24,4172800,279,129,150
1713,21,24,4172900,203,102,101
1714,21,24,4173000,300,157,143
1715,21,24,4173100,494,240,254
1716,21,24,4173200,667,343,324
1717,21,24,4173300,359,177,182
1718,21,24,4173400,111,59,52
1719,21,24,4173500,138,75,63
1720,21,24,4173600,562,281,281
1721,21,24,4173700,865,421,444
1722,21,24,4173800,234,132,102
1723,21,24,4173900,70,42,28
1724,21,24,4174000,574,297,277
1725,21,24,4174100,528,256,272
1726,21,24,4174200,1846,929,917
1727,21,24,4174300,456,218,238
1728,21,24,4174400,1194,595,599
1729,21,24,4174500,669,346,323
1730,21,24,4174600,841,430,411
1731,21,24,4174700,0,0,0
1732,21,24,4174800,1185,618,567
1733,21,24,4174900,494,241,253
1734,21,24,4175000,383,192,191
1735,21,24,4175100,763,362,401
1736,21,24,4175200,910,464,446
1737,21,24,4175300,743,383,360
1738,21,24,4175400,492,240,252
1739,21,24,4175500,575,298,277
1740,21,24,4175600,2001,1033,968
1741,21,24,4175700,199,90,109
1742,21,24,4175800,2240,1114,1126
1743,21,24,4175900,536,273,263
1744,21,24,4176000,948,481,467
1745,21,24,4176100,2089,1075,1014
1746,21,24,4176200,442,227,215
1747,21,24,4176300,2461,1250,1211
1748,21,24,4176400,113,54,59
1749,21,24,4176500,1020,510,510
1750,21,24,4176600,682,339,343
1751,21,24,4176700,1612,819,793
1752,21,24,4176800,1802,891,911
1753,21,24,4176900,347,175,172
1754,21,24,4177000,399,200,199
1755,21,24,4177100,236,117,119
1756,21,24,4177200,1872,942,930
1757,21,24,4177300,263,130,133
1758,21,24,4177400,340,171,169
1759,21,24,4177500,145,69,76
1760,21,24,4177600,516,266,250
1761,21,24,4177700,2125,1070,1055
1762,21,24,4177800,557,291,266
1763,21,24,4177900,1434,700,734
1764,21,24,4178000,609,306,303
1765,21,24,4178100,5176,2616,2560
1766,21,24,4178200,541,260,281
1767,21,24,4178300,799,395,404
1768,21,24,4178400,638,322,316
1769,21,24,4178500,864,435,429
1770,21,24,4178600,701,358,343
1771,21,24,4178700,191,103,88
1772,21,24,4178800,691,355,336
1773,21,24,4178900,628,318,310
1774,21,24,4179000,557,277,280
1775,21,24,4179100,49,25,24
1776,21,24,4179200,456,230,226
1777,21,24,4179300,470,232,238
1778,21,24,4179400,579,304,275
1779,21,24,4179500,135,69,66
1780,21,24,4179600,412,212,200
1781,21,24,4179700,831,417,414
1782,21,24,4179800,714,353,361
1783,21,24,4179900,974,492,482
1784,21,24,4180000,352,180,172
1785,21,24,4180100,489,246,243
1786,21,24,4180200,812,409,403
1787,21,24,4180300,211,112,99
1788,21,24,4180400,444,241,203
1789,21,24,4180500,782,394,388
1790,21,24,4180600,633,326,307
1791,21,24,4180700,1273,635,638
1792,21,24,4180800,1209,645,564
1793,21,24,4180900,865,410,455
