,Statecode,Districtcode,VillageCode,Population,Males,Females
0,21,386,2722800,249,121,128
1,21,386,2722900,371,181,190
2,21,386,2723000,489,256,233
3,21,386,2723100,64,34,30
4,21,386,2723200,539,295,244
5,21,386,2723300,1254,654,600
6,21,386,2723400,271,133,138
7,21,386,2723500,118,53,65
8,21,386,2723600,1174,608,566
9,21,386,2723700,429,220,209
10,21,386,2723800,945,474,471
11,21,386,2723900,352,177,175
12,21,386,2724000,2,2,0
13,21,386,2724100,1799,889,910
14,21,386,2724200,653,331,322
15,21,386,2724300,991,525,466
16,21,386,2724400,1912,987,925
17,21,386,2724500,349,176,173
18,21,386,2724600,275,153,122
19,21,386,2724700,545,289,256
20,21,386,2724800,1450,728,722
21,21,386,2724900,566,291,275
22,21,386,2725000,1128,584,544
23,21,386,2725100,245,116,129
24,21,386,2725200,2,2,0
25,21,386,2725300,281,134,147
26,21,386,2725400,757,376,381
27,21,386,2725500,959,438,521
28,21,386,2725600,92,44,48
29,21,386,2725700,0,0,0
30,21,386,2725800,2317,1152,1165
31,21,386,2725900,598,303,295
32,21,386,2726000,490,249,241
33,21,386,2726100,1697,856,841
34,21,386,2726200,257,122,135
35,21,386,2726300,303,154,149
36,21,386,2726400,157,75,82
37,21,386,2726500,171,95,76
38,21,386,2726600,656,334,322
39,21,386,2726700,0,0,0
40,21,386,2726800,314,164,150
41,21,386,2726900,357,167,190
42,21,386,2727000,164,80,84
43,21,386,2727100,768,356,412
44,21,386,2727200,647,327,320
45,21,386,2727300,696,346,350
46,21,386,2727400,236,116,120
47,21,386,2727500,430,226,204
48,21,386,2727600,485,243,242
49,21,386,2727700,664,313,351
50,21,386,2727800,447,223,224
51,21,386,2727900,328,176,152
52,21,386,2728000,412,196,216
53,21,386,2728100,717,376,341
54,21,386,2728200,919,582,337
55,21,386,2728300,468,237,231
56,21,386,2728400,13,7,6
57,21,386,2728500,0,0,0
58,21,386,2728600,1102,568,534
59,21,386,2728700,521,265,256
60,21,386,2728800,386,197,189
61,21,386,2728900,510,259,251
62,21,386,2729000,473,227,246
63,21,386,2729100,645,341,304
64,21,386,2729200,520,277,243
65,21,386,2729300,983,513,470
66,21,386,2729400,1189,603,586
67,21,386,2729500,1542,796,746
68,21,386,2729600,142,76,66
69,21,386,2729700,202,103,99
70,21,386,2729800,1048,536,512
71,21,386,2729900,627,316,311
72,21,386,2730000,305,145,160
73,21,386,2730100,206,97,109
74,21,386,2730200,525,280,245
75,21,386,2730300,381,189,192
76,21,386,2730400,420,233,187
77,21,386,2730500,0,0,0
78,21,386,2730600,0,0,0
79,21,386,2730700,341,188,153
80,21,386,2730800,919,459,460
81,21,386,2730900,0,0,0
82,21,386,2731000,855,402,453
83,21,386,2731100,325,165,160
84,21,386,2731200,356,183,173
85,21,386,2731300,164,85,79
86,21,386,2731400,600,296,304
87,21,386,2731500,455,230,225
88,21,386,2731600,334,179,155
89,21,386,2731700,795,419,376
90,21,386,2731800,0,0,0
91,21,386,2731900,616,311,305
92,21,386,2732000,449,245,204
93,21,386,2732100,325,157,168
94,21,386,2732200,363,170,193
95,21,386,2732300,358,179,179
96,21,386,2732400,0,0,0
97,21,386,2732500,386,195,191
98,21,386,2732600,965,501,464
99,21,386,2732700,946,492,454
100,21,386,2732800,1294,692,602
101,21,386,2732900,21,9,12
102,21,386,2733000,937,460,477
103,21,386,2733100,678,345,333
104,21,386,2733200,221,109,112
105,21,386,2733300,1676,814,862
106,21,386,2733400,1462,729,733
107,21,386,2733500,670,352,318
108,21,386,2733600,724,363,361
109,21,386,2733700,441,224,217
110,21,386,2733800,1374,690,684
111,21,386,2733900,244,124,120
112,21,386,2734000,591,307,284
113,21,386,2734100,658,339,319
114,21,386,2734200,370,189,181
115,21,386,2734300,1560,820,740
116,21,386,2734400,3472,1797,1675
117,21,386,2734500,213,106,107
118,21,386,2734600,2613,1364,1249
119,21,386,2734700,1669,811,858
120,21,386,2734800,291,139,152
121,21,386,2734900,151,81,70
122,21,386,2735000,0,0,0
123,21,386,2735100,79,45,34
124,21,386,2735200,494,261,233
125,21,386,2735300,411,215,196
126,21,386,2735400,504,255,249
127,21,386,2735500,202,104,98
128,21,386,2735600,0,0,0
129,21,386,2735700,2872,1466,1406
130,21,386,2735800,3581,1791,1790
131,21,386,2735900,876,441,435
132,21,386,2736000,375,203,172
133,21,386,2736100,1378,687,691
134,21,386,2736200,632,343,289
135,21,386,2736300,0,0,0
136,21,386,2736400,0,0,0
137,21,386,2736500,329,189,140
138,21,386,2736600,465,242,223
139,21,386,2736700,1772,910,862
140,21,386,2736800,97,45,52
141,21,386,2736900,503,260,243
142,21,386,2737000,3,2,1
143,21,386,2737100,0,0,0
144,21,386,2737200,538,284,254
145,21,386,2737300,176,93,83
146,21,386,2737400,870,448,422
147,21,386,2737500,879,447,432
148,21,386,2737600,0,0,0
149,21,386,2737700,958,485,473
150,21,386,2737800,777,401,376
151,21,386,2737900,443,213,230
152,21,386,2738000,399,195,204
153,21,386,2738100,383,195,188
154,21,386,2738200,1725,875,850
155,21,386,2738300,843,437,406
156,21,386,2738400,334,177,157
157,21,386,2738500,1217,629,588
158,21,386,2738600,1078,548,530
159,21,386,2738700,1090,545,545
160,21,386,2738800,1314,660,654
161,21,386,2738900,1170,632,538
162,21,386,2739000,645,308,337
163,21,386,2739100,1169,612,557
164,21,386,2739200,259,131,128
165,21,386,2739300,840,440,400
166,21,386,2739400,1869,977,892
167,21,386,2739500,689,338,351
168,21,386,2739600,2217,1105,1112
169,21,386,2739700,898,458,440
170,21,386,2739800,531,247,284
171,21,386,2739900,1276,639,637
172,21,386,2740000,79,33,46
173,21,386,2740100,630,337,293
174,21,386,2740200,0,0,0
175,21,386,2740300,0,0,0
176,21,386,2740400,0,0,0
177,21,386,2740500,55,28,27
178,21,386,2740600,936,486,450
179,21,386,2740700,375,199,176
180,21,386,2740800,23,11,12
181,21,386,2740900,543,277,266
182,21,386,2741000,106,51,55
183,21,386,2741100,0,0,0
184,21,386,2741200,432,214,218
185,21,386,2741300,128,63,65
186,21,386,2741400,361,182,179
187,21,386,2741500,262,139,123
188,21,386,2741600,103,55,48
189,21,386,2741700,161,88,73
190,21,386,2741800,267,128,139
191,21,386,2741900,0,0,0
192,21,386,2742000,368,188,180
193,21,386,2742100,68,29,39
194,21,386,2742200,1308,614,694
195,21,386,2742300,374,194,180
196,21,386,2742400,309,158,151
197,21,386,2742500,430,206,224
198,21,386,2742600,387,194,193
199,21,386,2742700,798,390,408
200,21,386,2742800,754,384,370
201,21,386,2742900,268,135,133
202,21,386,2743000,638,332,306
203,21,386,2743100,909,452,457
204,21,386,2743200,1627,826,801
205,21,386,2743300,1098,562,536
206,21,386,2743400,737,371,366
207,21,386,2743500,28,15,13
208,21,386,2743600,0,0,0
209,21,386,2743700,734,376,358
210,21,386,2743800,704,346,358
211,21,386,2743900,199,97,102
212,21,386,2744000,217,100,117
213,21,386,2744100,1246,642,604
214,21,386,2744200,414,211,203
215,21,386,2744300,99,47,52
216,21,386,2744400,0,0,0
217,21,386,2744500,0,0,0
218,21,386,2744600,436,209,227
219,21,386,2744700,988,494,494
220,21,386,2744800,151,80,71
221,21,386,2744900,0,0,0
222,21,386,2745000,2643,1340,1303
223,21,386,2745100,555,281,274
224,21,386,2745200,413,203,210
225,21,386,2745300,1212,638,574
226,21,386,2745400,2818,1374,1444
227,21,386,2745500,497,274,223
228,21,386,2745600,783,410,373
229,21,386,2745700,1092,561,531
230,21,386,2745800,991,522,469
231,21,386,2745900,664,335,329
232,21,386,2746000,1105,569,536
233,21,386,2746100,477,227,250
234,21,386,2746200,692,339,353
235,21,386,2746300,2024,1030,994
236,21,386,2746400,248,128,120
237,21,386,2746500,692,365,327
238,21,386,2746600,767,390,377
239,21,386,2746700,0,0,0
240,21,386,2746800,424,212,212
241,21,386,2746900,900,470,430
242,21,386,2747000,79,38,41
243,21,386,2747100,435,226,209
244,21,386,2747200,0,0,0
245,21,386,2747300,1411,699,712
246,21,386,2747400,959,476,483
247,21,386,2747500,486,249,237
248,21,386,2747600,428,203,225
249,21,386,2747700,179,93,86
250,21,386,2747800,148,76,72
251,21,386,2747900,1946,970,976
252,21,386,2748000,1679,828,851
253,21,386,2748100,1154,594,560
254,21,386,2748200,958,468,490
255,21,386,2748300,590,286,304
256,21,386,2748400,477,247,230
257,21,386,2748500,855,423,432
258,21,386,2748600,494,245,249
259,21,386,2748700,1102,562,540
260,21,386,2748800,74,44,30
261,21,386,2748900,86,40,46
262,21,386,2749000,105,53,52
263,21,386,2749100,716,369,347
264,21,386,2749200,639,323,316
265,21,386,2749300,492,255,237
266,21,386,2749400,104,56,48
267,21,386,2749500,5,2,3
268,21,386,2749600,596,305,291
269,21,386,2749700,689,352,337
270,21,386,2749800,422,229,193
271,21,386,2749900,654,345,309
272,21,386,2750000,723,347,376
273,21,386,2750100,335,172,163
274,21,386,2750200,134,68,66
275,21,386,2750300,225,107,118
276,21,386,2750400,375,193,182
277,21,386,2750500,905,449,456
278,21,386,2750600,473,242,231
279,21,386,2750700,1229,634,595
280,21,386,2750800,2187,1103,1084
281,21,386,2750900,29,14,15
282,21,386,2751000,1763,911,852
283,21,386,2751100,386,191,195
284,21,386,2751200,373,184,189
285,21,386,2751300,829,411,418
286,21,386,2751400,269,137,132
287,21,386,2751500,308,155,153
288,21,386,2751600,287,152,135
289,21,386,2751700,1055,538,517
290,21,386,2751800,1739,894,845
291,21,386,2751900,835,412,423
292,21,386,2752000,868,437,431
293,21,386,2752100,1038,510,528
294,21,386,2752200,821,383,438
295,21,386,2752300,495,233,262
296,21,386,2752400,551,260,291
297,21,386,2752500,634,326,308
298,21,386,2752600,903,453,450
299,21,386,2752700,1357,689,668
300,21,386,2752800,755,389,366
301,21,386,2752900,227,124,103
302,21,386,2753000,0,0,0
303,21,386,2753100,1012,522,490
304,21,386,2753200,0,0,0
305,21,386,2753300,822,404,418
306,21,386,2753400,1031,500,531
307,21,386,2753500,483,250,233
308,21,386,2753600,1637,799,838
309,21,386,2753700,1651,822,829
310,21,386,2753800,901,454,447
311,21,386,2753900,383,202,181
312,21,386,2754000,646,334,312
313,21,386,2754100,390,212,178
314,21,386,2754200,8,4,4
315,21,386,2754300,1444,711,733
316,21,386,2754400,945,473,472
317,21,386,2754500,704,352,352
318,21,386,2754600,1503,762,741
319,21,386,2754700,670,327,343
320,21,386,2754800,720,361,359
321,21,386,2754900,953,471,482
322,21,386,2755000,1458,755,703
323,21,386,2755100,580,317,263
324,21,386,2755200,1911,958,953
325,21,386,2755300,1993,1037,956
326,21,386,2755400,1502,719,783
327,21,386,2755500,695,349,346
328,21,386,2755600,1557,835,722
329,21,386,2755700,524,275,249
330,21,386,2755800,1223,622,601
331,21,386,2755900,1177,584,593
332,21,386,2756000,1333,669,664
333,21,386,2756100,344,178,166
334,21,386,2756200,221,118,103
335,21,386,2756300,1224,646,578
336,21,386,2756400,1586,769,817
337,21,386,2756500,1544,796,748
338,21,386,2756600,1476,768,708
339,21,386,2756700,1380,732,648
340,21,386,2756800,2570,1304,1266
341,21,386,2756900,717,368,349
342,21,386,2757000,925,468,457
343,21,386,2757100,225,113,112
344,21,386,2757200,683,367,316
345,21,386,2757300,1177,606,571
346,21,386,2757400,1242,646,596
347,21,386,2757500,835,407,428
348,21,386,2757600,3536,1772,1764
349,21,386,2757700,646,339,307
350,21,386,2757800,627,319,308
351,21,386,2757900,833,449,384
352,21,386,2758000,567,299,268
353,21,386,2758100,1462,714,748
354,21,386,2758200,699,368,331
355,21,386,2758300,627,325,302
356,21,386,2758400,1041,534,507
357,21,386,2758500,0,0,0
358,21,386,2758600,556,279,277
359,21,386,2758700,1175,605,570
360,21,386,2758800,664,345,319
361,21,386,2758900,319,170,149
362,21,386,2759000,0,0,0
363,21,386,2759100,3131,1603,1528
364,21,386,2759200,1397,677,720
365,21,386,2759300,1535,815,720
366,21,386,2759400,629,327,302
367,21,386,2759500,630,301,329
368,21,386,2759600,1084,539,545
369,21,386,2759700,696,331,365
370,21,386,2759800,1578,811,767
371,21,386,2759900,0,0,0
372,21,386,2760000,0,0,0
373,21,386,2760100,871,436,435
374,21,386,2760200,1018,518,500
375,21,386,2760300,500,251,249
376,21,386,2760400,1398,736,662
377,21,386,2760500,1331,662,669
378,21,386,2760600,2185,1138,1047
379,21,386,2760700,590,289,301
380,21,386,2760800,1148,593,555
381,21,386,2760900,943,488,455
382,21,386,2761000,284,142,142
383,21,386,2761100,759,376,383
384,21,386,2761200,0,0,0
385,21,386,2761300,766,405,361
386,21,386,2761400,1584,781,803
387,21,386,2761500,0,0,0
388,21,386,2761600,0,0,0
389,21,386,2761700,1829,942,887
390,21,386,2761800,833,400,433
391,21,386,2761900,677,332,345
392,21,386,2762000,376,187,189
393,21,386,2762100,1054,558,496
394,21,386,2762200,585,313,272
395,21,386,2762300,600,316,284
396,21,386,2762400,107,53,54
397,21,386,2762500,922,465,457
398,21,386,2762600,0,0,0
399,21,386,2762700,490,244,246
400,21,386,2762800,891,462,429
401,21,386,2762900,744,381,363
402,21,386,2763000,213,101,112
403,21,386,2763100,598,313,285
404,21,386,2763200,1632,840,792
405,21,386,2763300,0,0,0
406,21,386,2763400,3309,1698,1611
407,21,386,2763500,1475,757,718
408,21,386,2763600,2774,1406,1368
409,21,386,2763700,185,104,81
410,21,386,2763800,1710,874,836
411,21,386,2763900,0,0,0
412,21,386,2764000,2420,1247,1173
413,21,386,2764100,699,355,344
414,21,386,2764200,191,98,93
415,21,386,2764300,249,115,134
416,21,386,2764400,756,368,388
417,21,386,2764500,1014,502,512
418,21,386,2764600,488,247,241
419,21,386,2764700,760,378,382
420,21,386,2764800,182,100,82
421,21,386,2764900,683,339,344
422,21,386,2765000,650,338,312
423,21,386,2765100,642,322,320
424,21,386,2765200,988,474,514
425,21,386,2765300,269,133,136
426,21,386,2765400,630,309,321
427,21,386,2765500,1098,575,523
428,21,386,2765600,769,406,363
429,21,386,2765700,1111,578,533
430,21,386,2765800,418,214,204
431,21,386,2765900,593,310,283
432,21,386,2766000,4904,2487,2417
433,21,386,2766100,861,430,431
434,21,386,2766200,338,166,172
435,21,386,2766300,570,285,285
436,21,386,2766400,943,500,443
437,21,386,2766500,658,333,325
438,21,386,2766600,898,464,434
439,21,386,2766700,741,377,364
440,21,386,2766800,1072,564,508
441,21,386,2766900,1536,821,715
442,21,386,2767000,4366,2279,2087
443,21,386,2767100,880,446,434
444,21,386,2767200,551,281,270
445,21,386,2767300,2600,1314,1286
446,21,386,2767400,212,98,114
447,21,386,2767500,520,251,269
448,21,386,2767600,0,0,0
449,21,386,2767700,1623,844,779
450,21,386,2767800,754,390,364
451,21,386,2767900,1757,912,845
452,21,386,2768000,916,496,420
453,21,386,2768100,4303,2202,2101
454,21,386,2768200,1495,724,771
455,21,386,2768300,1745,899,846
456,21,386,2768400,0,0,0
457,21,386,2768500,1150,588,562
458,21,386,2768600,1674,841,833
459,21,386,2768700,2651,1321,1330
460,21,386,2768800,25,17,8
461,21,386,2768900,45,23,22
462,21,386,2769000,676,337,339
463,21,386,2769100,3159,1584,1575
464,21,386,2769200,1078,533,545
465,21,386,2769300,1339,670,669
466,21,386,2769400,488,248,240
467,21,386,2769500,1284,645,639
468,21,386,2769600,0,0,0
469,21,386,2769700,0,0,0
470,21,386,2769800,1370,702,668
471,21,386,2769900,371,183,188
472,21,386,2770000,208,99,109
473,21,386,2770100,564,287,277
474,21,386,2770200,478,220,258
475,21,386,2770300,2691,1355,1336
476,21,386,2770400,67,38,29
477,21,386,2770500,3440,1741,1699
478,21,386,2770600,293,163,130
479,21,386,2770700,113,63,50
480,21,386,2770800,2134,1105,1029
481,21,386,2770900,2858,1495,1363
482,21,386,2771000,291,130,161
483,21,386,2771100,1683,898,785
484,21,386,2771200,105,62,43
485,21,386,2771300,694,373,321
486,21,386,2771400,519,261,258
487,21,386,2771500,2696,1368,1328
488,21,386,2771600,2634,1309,1325
489,21,386,2771700,2151,1055,1096
490,21,386,2771800,1566,791,775
491,21,386,2771900,1054,537,517
492,21,386,2772000,2012,1000,1012
493,21,386,2772100,97,61,36
494,21,386,2772200,0,0,0
495,21,386,2772300,1218,624,594
496,21,386,2772400,1741,899,842
497,21,386,2772500,2718,1358,1360
498,21,386,2772600,1352,728,624
499,21,386,2772700,1327,682,645
500,21,386,2772800,267,140,127
501,21,386,2772900,754,401,353
502,21,386,2773000,0,0,0
503,21,386,2773100,0,0,0
504,21,386,2773200,0,0,0
505,21,386,2773300,0,0,0
506,21,386,2773400,269,139,130
507,21,386,2773500,4045,2068,1977
508,21,386,2773600,1635,825,810
509,21,386,2773700,963,488,475
510,21,386,2773800,755,396,359
511,21,386,2773900,749,374,375
512,21,386,2774000,741,384,357
513,21,386,2774100,1686,885,801
514,21,386,2774200,711,376,335
515,21,386,2774300,1537,805,732
516,21,386,2774400,1983,999,984
517,21,386,2774500,1544,781,763
518,21,386,2774600,0,0,0
519,21,386,2774700,1111,550,561
520,21,386,2774800,750,399,351
521,21,386,2774900,0,0,0
522,21,386,2775000,2258,1124,1134
523,21,386,2775100,876,449,427
524,21,386,2775200,924,464,460
525,21,386,2775300,93,50,43
526,21,386,2775400,1454,777,677
527,21,386,2775500,351,172,179
528,21,386,2775600,0,0,0
529,21,386,2775700,1857,957,900
530,21,386,2775800,1340,711,629
531,21,386,2775900,16,8,8
532,21,386,2776000,579,302,277
533,21,386,2776100,948,562,386
534,21,386,2776200,0,0,0
535,21,386,2776300,194,93,101
536,21,386,2776400,807,402,405
537,21,386,2776500,566,268,298
538,21,386,2776600,341,172,169
539,21,386,2776700,317,148,169
540,21,386,2776800,1244,605,639
541,21,386,2776900,2842,1484,1358
542,21,386,2777000,817,412,405
543,21,386,2777100,664,351,313
544,21,386,2777200,670,332,338
545,21,386,2777300,823,425,398
546,21,386,2777400,0,0,0
547,21,386,2777500,206,97,109
548,21,386,2777600,850,448,402
549,21,386,2777700,1035,520,515
550,21,386,2777800,1243,634,609
551,21,386,2777900,716,362,354
552,21,386,2778000,2817,1440,1377
553,21,386,2778100,1490,750,740
554,21,386,2778200,508,260,248
555,21,386,2778300,609,320,289
556,21,386,2778400,1120,563,557
557,21,386,2778500,594,302,292
558,21,386,2778600,3309,1681,1628
559,21,386,2778700,683,350,333
560,21,386,2778800,1265,634,631
561,21,386,2778900,3508,1771,1737
562,21,386,2779000,676,347,329
563,21,386,2779100,3156,1603,1553
564,21,386,2779200,1517,761,756
565,21,386,2779300,262,147,115
566,21,386,2779400,2242,1159,1083
567,21,386,2779500,2789,1428,1361
568,21,386,2779600,393,183,210
569,21,386,2779700,458,230,228
570,21,386,2779800,2453,1198,1255
571,21,386,2779900,383,190,193
572,21,386,2780000,2419,1216,1203
573,21,386,2780100,2557,1282,1275
574,21,386,2780200,2837,1492,1345
575,21,386,2780300,563,286,277
576,21,386,2780400,861,464,397
577,21,386,2780500,3013,1547,1466
578,21,386,2780600,2108,1096,1012
579,21,386,2780700,978,476,502
580,21,386,2780800,540,261,279
581,21,386,2780900,2519,1328,1191
582,21,386,2781000,291,143,148
583,21,386,2781100,284,147,137
584,21,386,2781200,113,63,50
585,21,386,2781300,466,237,229
586,21,386,2781400,3932,1998,1934
587,21,386,2781500,653,327,326
588,21,386,2781600,546,278,268
589,21,386,2781700,3468,1755,1713
590,21,386,2781800,4553,2291,2262
591,21,386,2781900,4659,2355,2304
592,21,386,2782000,450,232,218
593,21,386,2782100,951,465,486
594,21,386,2782200,4286,2254,2032
595,21,386,2782300,977,491,486
596,21,386,2782400,117,62,55
597,21,386,2782500,805,410,395
598,21,386,2782600,107,59,48
599,21,386,2782700,232,110,122
600,21,386,2782800,0,0,0
601,21,386,2782900,616,308,308
602,21,386,2783000,5451,2856,2595
603,21,386,2783100,331,176,155
604,21,386,2783200,2596,1340,1256
605,21,386,2783300,2401,1226,1175
606,21,386,2783400,1356,717,639
607,21,386,2783500,141,73,68
608,21,386,2783600,128,70,58
609,21,386,2783700,1012,490,522
610,21,386,2783800,462,233,229
611,21,386,2783900,587,308,279
612,21,386,2784000,954,476,478
613,21,386,2784100,362,196,166
614,21,386,2784200,572,289,283
615,21,386,2784300,716,374,342
616,21,386,2784400,357,179,178
617,21,386,2784500,557,302,255
618,21,386,2784600,969,501,468
619,21,386,2784700,461,239,222
620,21,386,2784800,566,281,285
621,21,386,2784900,1195,605,590
622,21,386,2785000,849,424,425
623,21,386,2785100,56,27,29
624,21,386,2785200,1027,508,519
625,21,386,2785300,941,460,481
626,21,386,2785400,190,99,91
627,21,386,2785500,501,245,256
628,21,386,2785600,152,81,71
629,21,386,2785700,1783,900,883
630,21,386,2785800,1007,501,506
631,21,386,2785900,575,268,307
632,21,386,2786000,1103,554,549
633,21,386,2786100,2777,1374,1403
634,21,386,2786200,340,193,147
635,21,386,2786300,567,275,292
636,21,386,2786400,888,446,442
637,21,386,2786500,1811,906,905
638,21,386,2786600,335,166,169
639,21,386,2786700,179,94,85
640,21,386,2786800,772,392,380
641,21,386,2786900,835,441,394
642,21,386,2787000,75,45,30
643,21,386,2787100,777,389,388
644,21,386,2787200,115,64,51
645,21,386,2787300,728,377,351
646,21,386,2787400,310,158,152
647,21,386,2787500,919,474,445
648,21,386,2787600,19,7,12
649,21,386,2787700,52,26,26
650,21,386,2787800,528,285,243
651,21,386,2787900,2351,1241,1110
652,21,386,2788000,846,442,404
653,21,386,2788100,1087,540,547
654,21,386,2788200,533,267,266
655,21,386,2788300,3081,1542,1539
656,21,386,2788400,2515,1274,1241
657,21,386,2788500,1254,648,606
658,21,386,2788600,924,470,454
659,21,386,2788700,987,490,497
660,21,386,2788800,1073,539,534
661,21,386,2788900,1031,528,503
662,21,386,2789000,2676,1385,1291
663,21,386,2789100,748,389,359
664,21,386,2789200,130,63,67
665,21,386,2789300,922,448,474
666,21,386,2789400,1724,859,865
667,21,386,2789500,2372,1226,1146
668,21,386,2789600,0,0,0
669,21,386,2789700,828,411,417
670,21,386,2789800,19,11,8
671,21,386,2789900,4136,2119,2017
672,21,386,2790000,2714,1358,1356
673,21,386,2790100,1157,598,559
674,21,386,2790200,1599,801,798
675,21,386,2790300,725,346,379
676,21,386,2790400,1743,886,857
677,21,386,2790500,2103,1074,1029
678,21,386,2790600,1947,984,963
679,21,386,2790700,1181,606,575
680,21,386,2790800,1730,837,893
681,21,386,2790900,1309,689,620
682,21,386,2791000,6006,3103,2903
683,21,386,2791100,1592,816,776
684,21,386,2791200,7481,3819,3662
685,21,386,2791300,437,218,219
686,21,386,2791400,7234,3644,3590
687,21,386,2791500,261,139,122
688,21,386,2791600,546,278,268
689,21,386,2791700,609,295,314
690,21,386,2791800,1136,582,554
691,21,386,2791900,3382,1759,1623
692,21,386,2792000,2028,1001,1027
693,21,386,2792100,1488,755,733
694,21,386,2792200,1062,554,508
695,21,386,2792300,1688,837,851
696,21,386,2792400,1045,546,499
697,21,386,2792500,681,346,335
698,21,386,2792600,2163,1126,1037
699,21,386,2792700,161,81,80
700,21,386,2792800,175,94,81
701,21,386,2792900,1850,957,893
702,21,386,2793000,1841,947,894
703,21,386,2793100,2395,1230,1165
704,21,386,2793200,729,357,372
705,21,386,2793300,870,430,440
706,21,386,2793400,1591,809,782
707,21,386,2793500,244,116,128
708,21,386,2793600,617,325,292
709,21,386,2793700,1320,668,652
710,21,386,2793800,1543,797,746
711,21,386,2793900,532,290,242
712,21,386,2794000,0,0,0
713,21,386,2794100,301,146,155
714,21,386,2794200,1289,644,645
715,21,386,2794300,239,128,111
716,21,386,2794400,1276,654,622
717,21,386,2794500,5003,2530,2473
718,21,386,2794600,343,191,152
719,21,386,2794700,111,51,60
720,21,386,2794800,554,272,282
721,21,386,2794900,488,238,250
722,21,386,2795000,1543,757,786
723,21,386,2795100,4138,2088,2050
724,21,386,2795200,906,460,446
725,21,386,2795300,831,425,406
726,21,386,2795400,1159,596,563
727,21,386,2795500,1326,664,662
728,21,386,2795600,732,369,363
729,21,386,2795700,323,164,159
730,21,386,2795800,6600,3281,3319
731,21,386,2795900,611,310,301
732,21,386,2796000,1063,532,531
733,21,386,2796100,729,378,351
734,21,386,2796200,636,331,305
735,21,386,2796300,486,250,236
736,21,386,2796400,460,235,225
737,21,386,2796500,488,243,245
738,21,386,2796600,344,178,166
739,21,386,2796700,331,151,180
740,21,386,2796800,416,217,199
741,21,386,2796900,259,133,126
742,21,386,2797000,837,435,402
743,21,386,2797100,912,441,471
744,21,386,2797200,1015,532,483
745,21,386,2797300,92,44,48
746,21,386,2797400,92,44,48
747,21,386,2797500,2770,1400,1370
748,21,386,2797600,420,211,209
749,21,386,2797700,858,434,424
750,21,386,2797800,1830,898,932
751,21,386,2797900,3843,1957,1886
752,21,386,2798000,1637,885,752
753,21,386,2798100,4749,2404,2345
754,21,386,2798200,840,432,408
755,21,386,2798300,0,0,0
756,21,386,2798400,1718,874,844
757,21,386,2798500,1265,651,614
758,21,386,2798600,39,25,14
759,21,386,2798700,16,9,7
760,21,386,2798800,319,172,147
761,21,386,2798900,618,322,296
762,21,386,2799000,408,212,196
763,21,386,2799100,219,112,107
764,21,386,2799200,412,202,210
765,21,386,2799300,895,462,433
766,21,386,2799400,371,187,184
767,21,386,2799500,395,201,194
768,21,386,2799600,480,259,221
769,21,386,2799700,0,0,0
770,21,386,2799800,851,425,426
771,21,386,2799900,0,0,0
772,21,386,2800000,461,248,213
773,21,386,2800100,431,223,208
774,21,386,2800200,695,346,349
775,21,386,2800300,155,82,73
776,21,386,2800400,295,155,140
777,21,386,2800500,200,100,100
778,21,386,2800600,1250,648,602
779,21,386,2800700,55,28,27
780,21,386,2800800,495,272,223
781,21,386,2800900,11,5,6
782,21,386,2801000,61,31,30
783,21,386,2801100,413,209,204
784,21,386,2801200,594,298,296
785,21,386,2801300,513,267,246
786,21,386,2801400,0,0,0
787,21,386,2801500,856,438,418
788,21,386,2801600,313,153,160
789,21,386,2801700,0,0,0
790,21,386,2801800,1420,719,701
791,21,386,2801900,742,375,367
792,21,386,2802000,235,115,120
793,21,386,2802100,189,104,85
794,21,386,2802200,350,172,178
795,21,386,2802300,0,0,0
796,21,386,2802400,1267,633,634
797,21,386,2802500,188,103,85
798,21,386,2802600,817,434,383
799,21,386,2802700,1781,898,883
800,21,386,2802800,1187,590,597
801,21,386,2802900,2241,1122,1119
802,21,386,2803000,0,0,0
803,21,386,2803100,1097,562,535
804,21,386,2803200,361,177,184
805,21,386,2803300,913,470,443
806,21,386,2803400,1213,599,614
807,21,386,2803500,846,431,415
808,21,386,2803600,531,272,259
809,21,386,2803700,219,117,102
810,21,386,2803800,73,40,33
811,21,386,2803900,1740,877,863
812,21,386,2804000,959,465,494
813,21,386,2804100,756,363,393
814,21,386,2804200,612,293,319
815,21,386,2804300,1278,653,625
816,21,386,2804400,509,266,243
817,21,386,2804500,0,0,0
818,21,386,2804600,514,250,264
819,21,386,2804700,5,2,3
820,21,386,2804800,373,181,192
821,21,386,2804900,1006,503,503
822,21,386,2805000,706,352,354
823,21,386,2805100,587,315,272
824,21,386,2805200,503,280,223
825,21,386,2805300,0,0,0
826,21,386,2805400,417,219,198
827,21,386,2805500,2916,1568,1348
828,21,386,2805600,1049,560,489
829,21,386,2805700,11,7,4
830,21,386,2805800,0,0,0
831,21,386,2805900,0,0,0
832,21,386,2806000,1915,978,937
833,21,386,2806100,1533,765,768
834,21,386,2806200,316,163,153
835,21,386,2806300,235,131,104
836,21,386,2806400,598,315,283
837,21,386,2806500,1814,894,920
838,21,386,2806600,900,477,423
839,21,386,2806700,2560,1292,1268
840,21,386,2806800,504,266,238
841,21,386,2806900,1286,668,618
842,21,386,2807000,1565,832,733
843,21,386,2807100,1237,628,609
844,21,386,2807200,1972,997,975
845,21,386,2807300,0,0,0
846,21,386,2807400,676,328,348
847,21,386,2807500,309,163,146
848,21,386,2807600,297,148,149
849,21,386,2807700,1571,810,761
850,21,386,2807800,2751,1368,1383
851,21,386,2807900,2954,1554,1400
852,21,386,2808000,3426,1778,1648
853,21,386,2808100,1268,665,603
854,21,386,2808200,485,256,229
855,21,386,2808300,1127,566,561
856,21,386,2808400,572,298,274
857,21,386,2808500,2347,1205,1142
858,21,386,2808600,253,121,132
859,21,386,2808700,1166,618,548
860,21,386,2808800,1130,558,572
861,21,386,2808900,498,249,249
862,21,386,2809000,2151,1139,1012
863,21,386,2809100,1330,659,671
864,21,386,2809200,0,0,0
865,21,386,2809300,0,0,0
866,21,386,2809400,3498,1729,1769
867,21,386,2809500,713,358,355
868,21,386,2809600,0,0,0
869,21,386,2809700,0,0,0
870,21,386,2809800,407,214,193
871,21,386,2809900,430,221,209
872,21,386,2810000,447,225,222
873,21,386,2810100,458,227,231
874,21,386,2810200,4071,2090,1981
875,21,386,2810300,0,0,0
876,21,386,2810400,0,0,0
877,21,386,2810500,0,0,0
878,21,386,2810600,1354,719,635
879,21,386,2810700,193,94,99
880,21,386,2810800,917,467,450
881,21,386,2810900,769,393,376
882,21,386,2811000,254,137,117
883,21,386,2811100,532,250,282
884,21,386,2811200,590,327,263
885,21,386,2811300,833,426,407
886,21,386,2811400,603,286,317
887,21,386,2811500,841,408,433
888,21,386,2811600,355,181,174
889,21,386,2811700,394,202,192
890,21,386,2811800,508,265,243
891,21,386,2811900,355,173,182
892,21,386,2812000,638,320,318
893,21,386,2812100,666,325,341
894,21,386,2812200,1102,534,568
895,21,386,2812300,184,80,104
896,21,386,2812400,255,139,116
897,21,386,2812500,429,219,210
898,21,386,2812600,640,314,326
899,21,386,2812700,2459,1187,1272
900,21,386,2812800,985,521,464
901,21,386,2812900,423,223,200
902,21,386,2813000,1470,729,741
903,21,386,2813100,1236,640,596
904,21,386,2813200,1392,718,674
905,21,386,2813300,1625,837,788
906,21,386,2813400,231,111,120
907,21,386,2813500,271,134,137
908,21,386,2813600,243,125,118
909,21,386,2813700,432,226,206
910,21,386,2813800,341,157,184
911,21,386,2813900,1778,892,886
912,21,386,2814000,82,49,33
913,21,386,2814100,1231,626,605
914,21,386,2814200,436,220,216
915,21,386,2814300,2449,1230,1219
916,21,386,2814400,1160,587,573
917,21,386,2814500,67,37,30
918,21,386,2814600,928,470,458
919,21,386,2814700,5105,2522,2583
920,21,386,2814800,1219,616,603
921,21,386,2814900,862,424,438
922,21,386,2815000,1068,563,505
923,21,386,2815100,485,249,236
924,21,386,2815200,572,285,287
925,21,386,2815300,699,352,347
926,21,386,2815400,545,277,268
927,21,386,2815500,1279,654,625
928,21,386,2815600,2871,1448,1423
929,21,386,2815700,0,0,0
930,21,386,2815800,344,166,178
931,21,386,2815900,2343,1172,1171
932,21,386,2816000,35,23,12
933,21,386,2816100,2220,1108,1112
934,21,386,2816200,1351,720,631
935,21,386,2816300,1751,895,856
936,21,386,2816400,0,0,0
937,21,386,2816500,0,0,0
938,21,386,2816600,1024,525,499
939,21,386,2816700,1790,888,902
940,21,386,2816800,2714,1375,1339
941,21,386,2816900,0,0,0
942,21,386,2817000,1587,813,774
943,21,386,2817100,1283,633,650
944,21,386,2817200,1219,623,596
945,21,386,2817300,609,315,294
946,21,386,2817400,0,0,0
947,21,386,2817500,10,5,5
948,21,386,2817600,828,404,424
949,21,386,2817700,519,242,277
950,21,386,2817800,804,388,416
951,21,386,2817900,223,116,107
952,21,386,2818000,554,280,274
953,21,386,2818100,261,124,137
954,21,386,2818200,460,233,227
955,21,386,2818300,274,140,134
956,21,386,2818400,56,26,30
957,21,386,2818500,453,219,234
958,21,386,2818600,0,0,0
959,21,386,2818700,0,0,0
960,21,386,2818800,0,0,0
961,21,386,2818900,1103,545,558
962,21,386,2819000,1361,710,651
963,21,386,2819100,10,7,3
964,21,386,2819200,73,32,41
965,21,386,2819300,0,0,0
966,21,386,2819400,485,253,232
967,21,386,2819500,155,86,69
968,21,386,2819600,0,0,0
969,21,386,2819700,0,0,0
970,21,386,2819800,0,0,0
971,21,386,2819900,664,316,348
972,21,386,2820000,1751,880,871
973,21,386,2820100,773,373,400
974,21,386,2820200,2812,1418,1394
975,21,386,2820300,0,0,0
976,21,386,2820400,641,310,331
977,21,386,2820500,1507,769,738
978,21,386,2820600,1138,578,560
979,21,386,2820700,247,124,123
980,21,386,2820800,1101,563,538
981,21,386,2820900,0,0,0
982,21,386,2821000,0,0,0
983,21,386,2821100,154,74,80
984,21,386,2821200,2415,1260,1155
985,21,386,2821300,466,229,237
986,21,386,2821400,520,261,259
987,21,386,2821500,141,73,68
988,21,386,2821600,0,0,0
989,21,386,2821700,76,46,30
990,21,386,2821800,164,75,89
991,21,386,2821900,1273,635,638
992,21,386,2822000,542,277,265
993,21,386,2822100,0,0,0
994,21,386,2822200,1189,579,610
995,21,386,2822300,1195,592,603
996,21,386,2822400,1063,544,519
997,21,386,2822500,622,301,321
998,21,386,2822600,1292,690,602
999,21,386,2822700,0,0,0
1000,21,386,2822800,250,141,109
1001,21,386,2822900,1503,778,725
1002,21,386,2823000,1072,539,533
1003,21,386,2823100,176,87,89
1004,21,386,2823200,530,279,251
1005,21,386,2823300,0,0,0
1006,21,386,2823400,3,3,0
1007,21,386,2823500,616,299,317
1008,21,386,2823600,0,0,0
1009,21,386,2823700,0,0,0
1010,21,386,2823800,165,87,78
1011,21,386,2823900,1200,600,600
1012,21,386,2824000,888,450,438
1013,21,386,2824100,0,0,0
1014,21,386,2824200,0,0,0
1015,21,386,2824300,0,0,0
1016,21,386,2824400,2392,1210,1182
1017,21,386,2824500,527,262,265
1018,21,386,2824600,474,238,236
1019,21,386,2824700,340,159,181
1020,21,386,2824800,308,146,162
1021,21,386,2824900,790,373,417
1022,21,386,2825000,851,408,443
1023,21,386,2825100,1243,615,628
1024,21,386,2825200,0,0,0
1025,21,386,2825300,274,137,137
1026,21,386,2825400,425,227,198
1027,21,386,2825500,3388,1759,1629
1028,21,386,2825600,904,458,446
1029,21,386,2825700,39,17,22
1030,21,386,2825800,143,70,73
1031,21,386,2825900,554,273,281
1032,21,386,2826000,840,443,397
1033,21,386,2826100,4416,2210,2206
1034,21,386,2826200,828,428,400
1035,21,386,2826300,2877,1450,1427
1036,21,386,2826400,446,231,215
1037,21,386,2826500,305,134,171
1038,21,386,2826600,488,268,220
1039,21,386,2826700,301,148,153
1040,21,386,2826800,394,195,199
1041,21,386,2826900,423,206,217
1042,21,386,2827000,736,376,360
1043,21,386,2827100,2216,1121,1095
1044,21,386,2827200,1521,749,772
1045,21,386,2827300,423,207,216
1046,21,386,2827400,562,284,278
1047,21,386,2827500,0,0,0
1048,21,386,2827600,0,0,0
1049,21,386,2827700,233,115,118
1050,21,386,2827800,230,101,129
1051,21,386,2827900,370,182,188
1052,21,386,2828000,287,135,152
1053,21,386,2828100,0,0,0
1054,21,386,2828200,332,167,165
1055,21,386,2828300,0,0,0
1056,21,386,2828400,10,4,6
1057,21,386,2828500,207,105,102
1058,21,386,2828600,0,0,0
1059,21,386,2828700,0,0,0
1060,21,386,2828800,0,0,0
1061,21,386,2828900,906,455,451
1062,21,386,2829000,139,75,64
1063,21,386,2829100,213,107,106
1064,21,386,2829200,482,260,222
1065,21,386,2829300,1620,834,786
1066,21,386,2829400,1249,638,611
1067,21,386,2829500,146,61,85
1068,21,386,2829600,563,275,288
1069,21,386,2829700,1731,850,881
1070,21,386,2829800,567,279,288
1071,21,386,2829900,628,287,341
1072,21,386,2830000,3599,1808,1791
1073,21,386,2830100,497,268,229
1074,21,386,2830200,4890,2523,2367
1075,21,386,2830300,904,478,426
1076,21,386,2830400,1483,769,714
1077,21,386,2830500,237,124,113
1078,21,386,2830600,0,0,0
1079,21,386,2830700,795,417,378
1080,21,386,2830800,837,423,414
1081,21,386,2830900,6939,3484,3455
1082,21,386,2831000,314,163,151
1083,21,386,2831100,804,426,378
1084,21,386,2831200,178,95,83
1085,21,386,2831300,1013,474,539
1086,21,386,2831400,410,199,211
1087,21,386,2831500,314,147,167
1088,21,386,2831600,1601,804,797
1089,21,386,2831700,0,0,0
1090,21,386,2831800,0,0,0
1091,21,386,2831900,376,193,183
1092,21,386,2832000,0,0,0
1093,21,386,2832100,1121,550,571
1094,21,386,2832200,979,495,484
1095,21,386,2832300,3132,1596,1536
1096,21,386,2832400,2244,1181,1063
1097,21,386,2832500,6839,3572,3267
1098,21,386,2832600,2948,1484,1464
1099,21,386,2832700,1177,602,575
1100,21,386,2832800,333,175,158
1101,21,386,2832900,804,395,409
1102,21,386,2833000,431,235,196
1103,21,386,2833100,2024,1031,993
1104,21,386,2833200,2064,1037,1027
1105,21,386,2833300,2967,1521,1446
1106,21,386,2833400,1074,548,526
1107,21,386,2833500,229,113,116
1108,21,386,2833600,123,63,60
1109,21,386,2833700,719,362,357
1110,21,386,2833800,298,152,146
1111,21,386,2833900,522,261,261
1112,21,386,2834000,0,0,0
1113,21,386,2834100,1321,714,607
1114,21,386,2834200,0,0,0
1115,21,386,2834300,946,496,450
1116,21,386,2834400,0,0,0
1117,21,386,2834500,0,0,0
1118,21,386,2834600,231,119,112
1119,21,386,2834700,527,274,253
1120,21,386,2834800,821,404,417
1121,21,386,2834900,626,315,311
1122,21,386,2835000,310,154,156
1123,21,386,2835100,918,472,446
1124,21,386,2835200,0,0,0
1125,21,386,2835300,38,16,22
1126,21,386,2835400,0,0,0
1127,21,386,2835500,1194,620,574
1128,21,386,2835600,0,0,0
1129,21,386,2835700,543,304,239
1130,21,386,2835800,676,362,314
1131,21,386,2835900,383,197,186
1132,21,386,2836000,799,416,383
1133,21,386,2836100,459,223,236
1134,21,386,2836200,0,0,0
1135,21,386,2836300,0,0,0
1136,21,386,2836400,5,2,3
1137,21,386,2836500,357,177,180
1138,21,386,2836600,296,139,157
1139,21,386,2836700,225,107,118
1140,21,386,2836800,205,106,99
1141,21,386,2836900,497,256,241
1142,21,386,2837000,378,188,190
1143,21,386,2837100,51,28,23
1144,21,386,2837200,159,83,76
1145,21,386,2837300,470,237,233
1146,21,386,2837400,190,95,95
1147,21,386,2837500,453,214,239
1148,21,386,2837600,814,383,431
1149,21,386,2837700,578,297,281
1150,21,386,2837800,680,339,341
1151,21,386,2837900,2416,1194,1222
1152,21,386,2838000,235,123,112
1153,21,386,2838100,57,26,31
1154,21,386,2838200,3412,1711,1701
1155,21,386,2838300,41,23,18
1156,21,386,2838400,4258,2102,2156
1157,21,386,2838500,1863,970,893
1158,21,386,2838600,236,123,113
1159,21,386,2838700,793,404,389
1160,21,386,2838800,232,121,111
1161,21,386,2838900,0,0,0
1162,21,386,2839000,50,23,27
1163,21,386,2839100,106,59,47
1164,21,386,2839200,20,11,9
1165,21,386,2839300,1252,647,605
1166,21,386,2839400,301,163,138
1167,21,386,2839500,2630,1285,1345
1168,21,386,2839600,2567,1292,1275
1169,21,386,2839700,0,0,0
1170,21,386,2839800,552,280,272
1171,21,386,2839900,191,100,91
1172,21,386,2840000,628,338,290
1173,21,386,2840100,984,506,478
1174,21,386,2840200,1243,635,608
1175,21,386,2840300,3214,1701,1513
1176,21,386,2840400,3973,2034,1939
1177,21,386,2840500,5166,2637,2529
1178,21,386,2840600,3524,1791,1733
1179,21,386,2840700,971,504,467
1180,21,386,2840800,2217,1140,1077
1181,21,386,2840900,3697,1881,1816
1182,21,386,2841000,5629,2870,2759
1183,21,386,2841100,4468,2329,2139
1184,21,386,2841200,6602,3452,3150
1185,21,386,2841300,401,213,188
1186,21,386,2841400,891,491,400
1187,21,386,2841500,662,340,322
1188,21,386,2841600,817,390,427
1189,21,386,2841700,808,402,406
1190,21,386,2841800,1007,520,487
1191,21,386,2841900,3689,1905,1784
1192,21,386,2842000,500,263,237
1193,21,386,2842100,315,152,163
1194,21,386,2842200,297,149,148
1195,21,386,2842300,0,0,0
1196,21,386,2842400,936,491,445
1197,21,386,2842500,3703,1825,1878
1198,21,386,2842600,0,0,0
1199,21,386,2842700,0,0,0
1200,21,386,2842800,365,196,169
1201,21,386,2842900,786,414,372
1202,21,386,2843000,720,357,363
1203,21,386,2843100,1200,627,573
1204,21,386,2843200,217,109,108
1205,21,386,2843300,1462,780,682
1206,21,386,2843400,208,104,104
1207,21,386,2843500,615,361,254
1208,21,386,2843600,1754,887,867
1209,21,386,2843700,600,321,279
1210,21,386,2843800,891,450,441
1211,21,386,2843900,0,0,0
1212,21,386,2844000,676,313,363
1213,21,386,2844100,2,1,1
1214,21,386,2844200,285,142,143
1215,21,386,2844300,0,0,0
1216,21,386,2844400,1699,835,864
1217,21,386,2844500,176,88,88
1218,21,386,2844600,1578,807,771
1219,21,386,2844700,1190,557,633
1220,21,386,2844800,2224,1139,1085
1221,21,386,2844900,1947,967,980
1222,21,386,2845000,0,0,0
1223,21,386,2845100,243,124,119
1224,21,386,2845200,809,462,347
1225,21,386,2845300,488,253,235
1226,21,386,2845400,1024,527,497
1227,21,386,2845500,7212,3692,3520
1228,21,386,2845600,465,243,222
1229,21,386,2845700,5579,2879,2700
1230,21,386,2845800,544,269,275
1231,21,386,2845900,25,11,14
1232,21,386,2846000,506,263,243
1233,21,386,2846100,1124,544,580
1234,21,386,2846200,597,286,311
1235,21,386,2846300,811,386,425
1236,21,386,2846400,325,178,147
1237,21,386,2846500,261,113,148
1238,21,386,2846600,0,0,0
1239,21,386,2846700,711,322,389
1240,21,386,2846800,8,4,4
1241,21,386,2846900,317,154,163
1242,21,386,2847000,405,196,209
1243,21,386,2847100,206,97,109
1244,21,386,2847200,429,231,198
1245,21,386,2847300,261,136,125
1246,21,386,2847400,335,175,160
1247,21,386,2847500,522,263,259
1248,21,386,2847600,407,188,219
1249,21,386,2847700,292,143,149
1250,21,386,2847800,219,98,121
1251,21,386,2847900,967,483,484
1252,21,386,2848000,164,79,85
1253,21,386,2848100,230,117,113
1254,21,386,2848200,0,0,0
1255,21,386,2848300,659,335,324
1256,21,386,2848400,377,188,189
1257,21,386,2848500,973,471,502
1258,21,386,2848600,191,89,102
1259,21,386,2848700,484,224,260
1260,21,386,2848800,537,248,289
1261,21,386,2848900,419,189,230
1262,21,386,2849000,49,17,32
1263,21,386,2849100,546,278,268
1264,21,386,2849200,370,185,185
1265,21,386,2849300,1523,756,767
1266,21,386,2849400,966,504,462
1267,21,386,2849500,676,321,355
1268,21,386,2849600,596,287,309
1269,21,386,2849700,635,287,348
1270,21,386,2849800,1188,645,543
1271,21,386,2849900,1333,624,709
1272,21,386,2850000,474,242,232
1273,21,386,2850100,549,295,254
1274,21,386,2850200,2843,1441,1402
1275,21,386,2850300,317,154,163
1276,21,386,2850400,610,315,295
1277,21,386,2850500,596,287,309
1278,21,386,2850600,808,426,382
1279,21,386,2850700,647,322,325
1280,21,386,2850800,455,218,237
1281,21,386,2850900,617,320,297
1282,21,386,2851000,76,34,42
1283,21,386,2851100,230,125,105
1284,21,386,2851200,242,123,119
1285,21,386,2851300,510,249,261
1286,21,386,2851400,353,166,187
1287,21,386,2851500,1196,602,594
1288,21,386,2851600,605,320,285
1289,21,386,2851700,52,32,20
1290,21,386,2851800,464,223,241
1291,21,386,2851900,188,89,99
1292,21,386,2852000,689,363,326
1293,21,386,2852100,291,149,142
1294,21,386,2852200,470,229,241
1295,21,386,2852300,615,322,293
1296,21,386,2852400,1539,774,765
1297,21,386,2852500,1145,554,591
1298,21,386,2852600,1583,837,746
1299,21,386,2852700,402,203,199
1300,21,386,2852800,136,69,67
1301,21,386,2852900,837,388,449
1302,21,386,2853000,995,478,517
1303,21,386,2853100,931,466,465
1304,21,386,2853200,1029,533,496
1305,21,386,2853300,495,248,247
1306,21,386,2853400,0,0,0
1307,21,386,2853500,370,188,182
1308,21,386,2853600,1085,544,541
1309,21,386,2853700,576,314,262
1310,21,386,2853800,665,339,326
1311,21,386,2853900,2606,1324,1282
1312,21,386,2854000,1418,750,668
1313,21,386,2854100,1787,911,876
1314,21,386,2854200,497,242,255
1315,21,386,2854300,21,11,10
1316,21,386,2854400,534,235,299
1317,21,386,2854500,423,182,241
1318,21,386,2854600,293,148,145
1319,21,386,2854700,508,247,261
1320,21,386,2854800,988,513,475
1321,21,386,2854900,248,118,130
1322,21,386,2855000,406,190,216
1323,21,386,2855100,0,0,0
1324,21,386,2855200,1754,852,902
1325,21,386,2855300,378,203,175
1326,21,386,2855400,820,416,404
1327,21,386,2855500,93,37,56
1328,21,386,2855600,664,334,330
1329,21,386,2855700,0,0,0
1330,21,386,2855800,0,0,0
1331,21,386,2855900,0,0,0
1332,21,386,2856000,0,0,0
1333,21,386,2856100,37,21,16
1334,21,386,2856200,226,109,117
1335,21,386,2856300,0,0,0
1336,21,386,2856400,50,25,25
1337,21,386,2856500,346,163,183
1338,21,386,2856600,295,137,158
1339,21,386,2856700,1271,635,636
1340,21,386,2856800,212,100,112
1341,21,386,2856900,0,0,0
1342,21,386,2857000,146,69,77
1343,21,386,2857100,0,0,0
1344,21,386,2857200,0,0,0
1345,21,386,2857300,254,142,112
1346,21,386,2857400,0,0,0
1347,21,386,2857500,0,0,0
1348,21,386,2857600,0,0,0
1349,21,386,2857700,0,0,0
1350,21,386,2857800,0,0,0
1351,21,386,2857900,2212,1130,1082
1352,21,386,2858000,375,176,199
1353,21,386,2858100,2868,1495,1373
1354,21,386,2858200,1869,948,921
1355,21,386,2858300,1009,509,500
1356,21,386,2858400,349,179,170
1357,21,386,2858500,718,363,355
1358,21,386,2858600,0,0,0
1359,21,386,2858700,381,169,212
1360,21,386,2858800,0,0,0
1361,21,386,2858900,388,170,218
1362,21,386,2859000,502,221,281
1363,21,386,2859100,1313,633,680
1364,21,386,2859200,1116,550,566
1365,21,386,2859300,0,0,0
1366,21,386,2859400,576,277,299
1367,21,386,2859500,534,268,266
1368,21,386,2859600,1692,886,806
1369,21,386,2859700,419,230,189
1370,21,386,2859800,526,241,285
1371,21,386,2859900,10,7,3
1372,21,386,2860000,1793,835,958
1373,21,386,2860100,1068,514,554
1374,21,386,2860200,624,311,313
1375,21,386,2860300,808,417,391
1376,21,386,2860400,2114,1030,1084
1377,21,386,2860500,1032,464,568
1378,21,386,2860600,0,0,0
1379,21,386,2860700,0,0,0
1380,21,386,2860800,369,154,215
1381,21,386,2860900,966,478,488
1382,21,386,2861000,0,0,0
1383,21,386,2861100,274,131,143
1384,21,386,2861200,1560,722,838
1385,21,386,2861300,1033,531,502
1386,21,386,2861400,97,49,48
1387,21,386,2861500,955,477,478
1388,21,386,2861600,201,105,96
1389,21,386,2861700,47,21,26
1390,21,386,2861800,0,0,0
1391,21,386,2861900,223,111,112
1392,21,386,2862000,298,157,141
1393,21,386,2862100,59,33,26
1394,21,386,2862200,0,0,0
1395,21,386,2862300,333,171,162
1396,21,386,2862400,231,109,122
1397,21,386,2862500,212,101,111
1398,21,386,2862600,345,169,176
1399,21,386,2862700,561,287,274
1400,21,386,2862800,765,376,389
1401,21,386,2862900,0,0,0
1402,21,386,2863000,304,152,152
1403,21,386,2863100,94,71,23
1404,21,386,2863200,205,99,106
1405,21,386,2863300,0,0,0
1406,21,386,2863400,73,40,33
1407,21,386,2863500,157,80,77
1408,21,386,2863600,28,14,14
1409,21,386,2863700,0,0,0
1410,21,386,2863800,0,0,0
1411,21,386,2863900,208,113,95
1412,21,386,2864000,0,0,0
1413,21,386,2864100,0,0,0
1414,21,386,2864200,211,104,107
1415,21,386,2864300,0,0,0
1416,21,386,2864400,45,22,23
1417,21,386,2864500,0,0,0
1418,21,386,2864600,62,35,27
1419,21,386,2864700,165,85,80
1420,21,386,2864800,289,129,160
1421,21,386,2864900,0,0,0
1422,21,386,2865000,0,0,0
1423,21,386,2865100,0,0,0
1424,21,386,2865200,0,0,0
1425,21,386,2865300,0,0,0
1426,21,386,2865400,0,0,0
1427,21,386,2865500,468,272,196
1428,21,386,2865600,0,0,0
1429,21,386,2865700,0,0,0
1430,21,386,2865800,32,13,19
1431,21,386,2865900,81,41,40
1432,21,386,2866000,39,13,26
1433,21,386,2866100,39,20,19
1434,21,386,2866200,75,35,40
1435,21,386,2866300,760,365,395
1436,21,386,2866400,77,37,40
1437,21,386,2866500,37,14,23
1438,21,386,2866600,0,0,0
1439,21,386,2866700,155,82,73
1440,21,386,2866800,510,262,248
1441,21,386,2866900,0,0,0
1442,21,386,2867000,0,0,0
1443,21,386,2867100,0,0,0
1444,21,386,2867200,0,0,0
1445,21,386,2867300,0,0,0
1446,21,386,2867400,407,171,236
1447,21,386,2867500,633,265,368
1448,21,386,2867600,0,0,0
1449,21,386,2867700,609,278,331
1450,21,386,2867800,444,202,242
1451,21,386,2867900,1019,490,529
1452,21,386,2868000,657,329,328
1453,21,386,2868100,1285,596,689
1454,21,386,2868200,853,376,477
1455,21,386,2868300,248,107,141
1456,21,386,2868400,0,0,0
1457,21,386,2868500,325,143,182
1458,21,386,2868600,593,305,288
1459,21,386,2868700,0,0,0
1460,21,386,2868800,0,0,0
1461,21,386,2868900,1043,490,553
1462,21,386,2869000,247,116,131
1463,21,386,2869100,149,64,85
1464,21,386,2869200,1177,569,608
1465,21,386,2869300,458,202,256
1466,21,386,2869400,912,482,430
1467,21,386,2869500,0,0,0
1468,21,386,2869600,0,0,0
1469,21,386,2869700,717,316,401
1470,21,386,2869800,1134,536,598
1471,21,386,2869900,2112,991,1121
1472,21,386,2870000,205,89,116
1473,21,386,2870100,1676,746,930
1474,21,386,2870200,145,69,76
1475,21,386,2870300,267,129,138
1476,21,386,2870400,333,148,185
1477,21,386,2870500,489,211,278
1478,21,386,2870600,891,429,462
1479,21,386,2870700,333,159,174
1480,21,386,2870800,1390,683,707
1481,21,386,2870900,1509,725,784
1482,21,386,2871000,946,471,475
1483,21,386,2871100,290,142,148
1484,21,386,2871200,357,173,184
1485,21,386,2871300,145,68,77
1486,21,386,2871400,689,316,373
1487,21,386,2871500,543,261,282
1488,21,386,2871600,0,0,0
1489,21,386,2871700,411,226,185
1490,21,386,2871800,0,0,0
1491,21,386,2871900,275,134,141
1492,21,386,2872000,177,71,106
1493,21,386,2872100,388,187,201
1494,21,386,2872200,1310,575,735
1495,21,386,2872300,454,225,229
1496,21,386,2872400,223,110,113
1497,21,386,2872500,2945,1436,1509
1498,21,386,2872600,0,0,0
1499,21,386,2872700,0,0,0
1500,21,386,2872800,301,139,162
1501,21,386,2872900,0,0,0
1502,21,386,2873000,40,23,17
1503,21,386,2873100,0,0,0
1504,21,386,2873200,0,0,0
1505,21,386,2873300,0,0,0
1506,21,386,2873400,687,345,342
1507,21,386,2873500,0,0,0
1508,21,386,2873600,0,0,0
1509,21,386,2873700,423,215,208
1510,21,386,2873800,504,280,224
1511,21,386,2873900,11,7,4
1512,21,386,2874000,365,184,181
1513,21,386,2874100,85,38,47
1514,21,386,2874200,4124,2169,1955
1515,21,386,2874300,220,103,117
1516,21,386,2874400,1212,626,586
1517,21,386,2874500,414,207,207
1518,21,386,2874600,135,68,67
1519,21,386,2874700,147,87,60
1520,21,386,2874800,656,327,329
1521,21,386,2874900,879,420,459
1522,21,386,2875000,1095,568,527
1523,21,386,2875100,763,367,396
1524,21,386,2875200,596,316,280
1525,21,386,2875300,882,459,423
1526,21,386,2875400,3143,1604,1539
1527,21,386,2875500,566,280,286
1528,21,386,2875600,1280,620,660
1529,21,386,2875700,0,0,0
1530,21,386,2875800,1808,942,866
1531,21,386,2875900,0,0,0
1532,21,386,2876000,0,0,0
1533,21,386,2876100,125,62,63
1534,21,386,2876200,35,19,16
1535,21,386,2876300,352,182,170
1536,21,386,2876400,109,58,51
1537,21,386,2876500,146,65,81
1538,21,386,2876600,629,298,331
1539,21,386,2876700,337,172,165
1540,21,386,2876800,594,290,304
1541,21,386,2876900,200,98,102
1542,21,386,2877000,570,266,304
1543,21,386,2877100,485,248,237
1544,21,386,2877200,128,68,60
1545,21,386,2877300,53,29,24
1546,21,386,2877400,0,0,0
1547,21,386,2877500,243,115,128
1548,21,386,2877600,142,64,78
1549,21,386,2877700,635,304,331
1550,21,386,2877800,446,221,225
