,Statecode,Districtcode,VillageCode,Population,Males,Females
0,21,2,120800,1088,544,544
1,21,2,120900,492,243,249
2,21,2,121000,1028,499,529
3,21,2,121100,1402,713,689
4,21,2,121200,925,453,472
5,21,2,121300,652,304,348
6,21,2,121400,303,159,144
7,21,2,121500,346,176,170
8,21,2,121600,172,87,85
9,21,2,121700,313,152,161
10,21,2,121800,565,291,274
11,21,2,121900,180,87,93
12,21,2,122000,160,79,81
13,21,2,122100,738,388,350
14,21,2,122200,1215,609,606
15,21,2,122300,940,487,453
16,21,2,122400,329,161,168
17,21,2,122500,237,123,114
18,21,2,122600,568,283,285
19,21,2,122700,736,375,361
20,21,2,122800,2244,1125,1119
21,21,2,122900,758,384,374
22,21,2,123000,77,36,41
23,21,2,123100,608,296,312
24,21,2,123200,437,226,211
25,21,2,123300,1856,942,914
26,21,2,123400,1105,555,550
27,21,2,123500,251,125,126
28,21,2,123600,980,494,486
29,21,2,123700,1174,602,572
30,21,2,123800,594,299,295
31,21,2,123900,834,419,415
32,21,2,124000,416,201,215
33,21,2,124100,534,281,253
34,21,2,124200,592,286,306
35,21,2,124300,1791,895,896
36,21,2,124400,145,69,76
37,21,2,124500,842,442,400
38,21,2,124600,416,211,205
39,21,2,124700,537,276,261
40,21,2,124800,484,252,232
41,21,2,124900,480,250,230
42,21,2,125000,1798,915,883
43,21,2,125100,973,483,490
44,21,2,125200,729,374,355
45,21,2,125300,578,309,269
46,21,2,125400,592,305,287
47,21,2,125500,486,247,239
48,21,2,125600,675,341,334
49,21,2,125700,471,228,243
50,21,2,125800,632,336,296
51,21,2,125900,227,112,115
52,21,2,126000,1971,992,979
53,21,2,126100,937,480,457
54,21,2,126200,1057,551,506
55,21,2,126300,137,67,70
56,21,2,126400,10,4,6
57,21,2,126500,796,392,404
58,21,2,126600,1185,591,594
59,21,2,126700,1070,535,535
60,21,2,126800,779,407,372
61,21,2,126900,183,89,94
62,21,2,127000,619,313,306
63,21,2,127100,2558,1294,1264
64,21,2,127200,2453,1255,1198
65,21,2,127300,529,260,269
66,21,2,127400,836,418,418
67,21,2,127500,327,177,150
68,21,2,127600,810,434,376
69,21,2,127700,781,408,373
70,21,2,127800,1012,500,512
71,21,2,127900,3397,1711,1686
72,21,2,128000,1667,870,797
73,21,2,128100,1334,667,667
74,21,2,128200,778,405,373
75,21,2,128300,944,487,457
76,21,2,128400,649,334,315
77,21,2,128500,1599,824,775
78,21,2,128600,487,246,241
79,21,2,128700,1126,626,500
80,21,2,128800,900,470,430
81,21,2,128900,3144,1617,1527
82,21,2,129000,3491,1765,1726
83,21,2,129100,756,376,380
84,21,2,129200,150,75,75
85,21,2,129300,1119,563,556
86,21,2,129400,1546,785,761
87,21,2,129500,1051,525,526
88,21,2,129600,2662,1365,1297
89,21,2,129700,534,262,272
90,21,2,129800,774,370,404
91,21,2,129900,413,208,205
92,21,2,130000,10,7,3
93,21,2,130100,65,29,36
94,21,2,130200,841,443,398
95,21,2,130300,944,491,453
96,21,2,130400,61,32,29
97,21,2,130500,1388,704,684
98,21,2,130600,2179,1100,1079
99,21,2,130700,899,458,441
100,21,2,130800,765,367,398
101,21,2,130900,1294,650,644
102,21,2,131000,358,176,182
103,21,2,131100,694,364,330
104,21,2,131200,577,299,278
105,21,2,131300,344,177,167
106,21,2,131400,1995,974,1021
107,21,2,131500,3099,1564,1535
108,21,2,131600,657,321,336
109,21,2,131700,292,143,149
110,21,2,131800,354,181,173
111,21,2,131900,600,294,306
112,21,2,132000,241,131,110
113,21,2,132100,476,245,231
114,21,2,132200,2259,1176,1083
115,21,2,132300,709,383,326
116,21,2,132400,966,512,454
117,21,2,132500,641,328,313
118,21,2,132600,904,457,447
119,21,2,132700,513,269,244
120,21,2,132800,2244,1160,1084
121,21,2,132900,8650,4614,4036
122,21,2,133000,817,411,406
123,21,2,133100,1359,691,668
124,21,2,133200,1933,956,977
125,21,2,133300,536,278,258
126,21,2,133400,2280,1138,1142
127,21,2,133500,490,247,243
128,21,2,133600,198,96,102
129,21,2,133700,435,229,206
130,21,2,133800,394,214,180
131,21,2,133900,1917,944,973
132,21,2,134000,1001,535,466
133,21,2,134100,792,405,387
134,21,2,134200,1540,818,722
135,21,2,134300,1467,728,739
136,21,2,134400,3798,2023,1775
137,21,2,134500,374,194,180
138,21,2,134600,1122,540,582
139,21,2,134700,3210,1612,1598
140,21,2,134800,1134,565,569
141,21,2,134900,2000,987,1013
142,21,2,135000,93,45,48
143,21,2,135100,297,156,141
144,21,2,135200,807,402,405
145,21,2,135300,1950,970,980
146,21,2,135400,241,128,113
147,21,2,135500,1402,700,702
148,21,2,135600,1059,530,529
149,21,2,135700,266,137,129
150,21,2,135800,313,154,159
151,21,2,135900,309,156,153
152,21,2,136000,580,297,283
153,21,2,136100,521,264,257
154,21,2,136200,700,368,332
155,21,2,136300,1367,683,684
156,21,2,136400,895,454,441
157,21,2,136500,918,424,494
158,21,2,136600,198,105,93
159,21,2,136700,334,161,173
160,21,2,136800,408,198,210
161,21,2,136900,71,38,33
162,21,2,137000,1107,579,528
163,21,2,137100,1351,707,644
164,21,2,137200,937,477,460
165,21,2,137300,2170,1100,1070
166,21,2,137400,1451,736,715
167,21,2,137500,1147,558,589
168,21,2,137600,36,22,14
169,21,2,137700,206,106,100
170,21,2,137800,516,256,260
171,21,2,137900,418,211,207
172,21,2,138000,804,414,390
173,21,2,138100,92,46,46
174,21,2,138200,435,246,189
175,21,2,138300,980,499,481
176,21,2,138400,4847,2531,2316
177,21,2,138500,549,283,266
178,21,2,138600,691,350,341
179,21,2,138700,331,177,154
180,21,2,138800,906,437,469
181,21,2,138900,2120,1061,1059
182,21,2,139000,1649,842,807
183,21,2,139100,2352,1201,1151
184,21,2,139200,500,272,228
185,21,2,139300,1334,691,643
186,21,2,139400,5033,2542,2491
187,21,2,139500,1080,555,525
188,21,2,139600,2176,1090,1086
189,21,2,139700,1182,580,602
190,21,2,139800,2650,1340,1310
191,21,2,139900,732,384,348
192,21,2,140000,1431,726,705
193,21,2,140100,1236,629,607
194,21,2,140200,852,422,430
195,21,2,140300,457,223,234
196,21,2,140400,476,237,239
197,21,2,140500,869,472,397
198,21,2,140600,569,296,273
199,21,2,140700,2259,1117,1142
200,21,2,140800,2304,1148,1156
201,21,2,140900,233,117,116
202,21,2,141000,1095,561,534
203,21,2,141100,4511,2265,2246
204,21,2,141200,222,109,113
205,21,2,141300,1222,627,595
206,21,2,141400,1283,626,657
207,21,2,141500,485,251,234
208,21,2,141600,1817,943,874
209,21,2,141700,172,89,83
210,21,2,141800,727,362,365
211,21,2,141900,430,209,221
212,21,2,142000,677,328,349
213,21,2,142100,393,193,200
214,21,2,142200,574,294,280
215,21,2,142300,209,110,99
216,21,2,142400,1844,928,916
217,21,2,142500,1052,533,519
218,21,2,142600,1368,678,690
219,21,2,142700,243,114,129
220,21,2,142800,1633,842,791
221,21,2,142900,1734,898,836
222,21,2,143000,802,427,375
223,21,2,143100,2032,1017,1015
224,21,2,143200,663,318,345
225,21,2,143300,632,322,310
226,21,2,143400,545,266,279
227,21,2,143500,1820,915,905
228,21,2,143600,449,231,218
229,21,2,143700,1321,651,670
230,21,2,143800,582,299,283
231,21,2,143900,749,376,373
232,21,2,144000,743,388,355
233,21,2,144100,159,81,78
234,21,2,144200,847,432,415
235,21,2,144300,1642,804,838
236,21,2,144400,869,441,428
237,21,2,144500,623,302,321
238,21,2,144600,389,175,214
239,21,2,144700,1990,985,1005
240,21,2,144800,126,53,73
241,21,2,144900,276,133,143
242,21,2,145000,2342,1161,1181
243,21,2,145100,1092,557,535
244,21,2,145200,551,281,270
245,21,2,145300,640,309,331
246,21,2,145400,588,254,334
247,21,2,145500,1550,759,791
248,21,2,145600,2614,1374,1240
249,21,2,145700,815,419,396
250,21,2,145800,52,28,24
251,21,2,145900,96,51,45
252,21,2,146000,180,92,88
253,21,2,146100,446,228,218
254,21,2,146200,148,69,79
255,21,2,146300,371,187,184
256,21,2,146400,1638,824,814
257,21,2,146500,1816,919,897
258,21,2,146600,100,51,49
259,21,2,146700,0,0,0
260,21,2,146800,665,325,340
261,21,2,146900,350,173,177
262,21,2,147000,108,57,51
263,21,2,147100,748,375,373
264,21,2,147200,923,470,453
265,21,2,147300,925,472,453
266,21,2,147400,533,261,272
267,21,2,147500,445,223,222
268,21,2,147600,2438,1205,1233
269,21,2,147700,2396,1175,1221
270,21,2,147800,549,255,294
271,21,2,147900,502,244,258
272,21,2,148000,1856,933,923
273,21,2,148100,1857,934,923
274,21,2,148200,30,15,15
275,21,2,148300,1063,518,545
276,21,2,148400,1002,494,508
277,21,2,148500,387,196,191
278,21,2,148600,2867,1474,1393
279,21,2,148700,422,220,202
280,21,2,148800,840,421,419
281,21,2,148900,5134,2753,2381
282,21,2,149000,580,294,286
283,21,2,149100,629,306,323
284,21,2,149200,1822,924,898
285,21,2,149300,1069,566,503
286,21,2,149400,380,205,175
287,21,2,149500,1064,522,542
288,21,2,149600,571,281,290
289,21,2,149700,460,229,231
290,21,2,149800,1396,691,705
291,21,2,149900,1618,829,789
292,21,2,150000,309,144,165
293,21,2,150100,4048,1988,2060
294,21,2,150200,2550,1275,1275
295,21,2,150300,443,220,223
296,21,2,150400,1665,848,817
297,21,2,150500,3091,1550,1541
298,21,2,150600,397,185,212
299,21,2,150700,3975,2000,1975
300,21,2,150800,828,429,399
301,21,2,150900,2265,1147,1118
302,21,2,151000,701,347,354
303,21,2,151100,1529,770,759
304,21,2,151200,897,462,435
305,21,2,151300,516,252,264
306,21,2,151400,226,120,106
307,21,2,151500,3278,1629,1649
308,21,2,151600,2132,1065,1067
309,21,2,151700,1850,922,928
310,21,2,151800,1741,887,854
311,21,2,151900,1147,620,527
312,21,2,152000,1688,853,835
313,21,2,152100,656,335,321
314,21,2,152200,218,112,106
315,21,2,152300,909,435,474
316,21,2,152400,819,420,399
317,21,2,152500,389,206,183
318,21,2,152600,327,144,183
319,21,2,152700,0,0,0
320,21,2,152800,483,254,229
321,21,2,152900,1077,516,561
322,21,2,153000,2357,1197,1160
323,21,2,153100,2816,1388,1428
324,21,2,153200,1563,815,748
325,21,2,153300,2681,1357,1324
326,21,2,153400,877,420,457
327,21,2,153500,461,237,224
328,21,2,153600,1521,760,761
329,21,2,153700,321,158,163
330,21,2,153800,4312,2155,2157
331,21,2,153900,479,241,238
332,21,2,154000,877,417,460
333,21,2,154100,540,269,271
334,21,2,154200,738,368,370
335,21,2,154300,752,382,370
336,21,2,154400,119,71,48
337,21,2,154500,1133,563,570
338,21,2,154600,1181,571,610
339,21,2,154700,558,273,285
340,21,2,154800,76,40,36
341,21,2,154900,1194,620,574
342,21,2,155000,2159,1095,1064
343,21,2,155100,832,424,408
344,21,2,155200,993,487,506
345,21,2,155300,1068,520,548
346,21,2,155400,147,72,75
347,21,2,155500,180,87,93
