,Statecode,Districtcode,VillageCode,Population,Males,Females
0,21,20,3521300,98,50,48
1,21,20,3521400,347,165,182
2,21,20,3521500,334,141,193
3,21,20,3521600,124,59,65
4,21,20,3521700,263,103,160
5,21,20,3521800,63,35,28
6,21,20,3521900,249,110,139
7,21,20,3522000,66,34,32
8,21,20,3522100,54,31,23
9,21,20,3522200,4,3,1
10,21,20,3522300,42,23,19
11,21,20,3522400,0,0,0
12,21,20,3522500,33,18,15
13,21,20,3522600,52,23,29
14,21,20,3522700,54,21,33
15,21,20,3522800,550,266,284
16,21,20,3522900,187,96,91
17,21,20,3523000,206,104,102
18,21,20,3523100,81,42,39
19,21,20,3523200,154,67,87
20,21,20,3523300,315,163,152
21,21,20,3523400,295,149,146
22,21,20,3523500,315,158,157
23,21,20,3523600,246,120,126
24,21,20,3523700,144,72,72
25,21,20,3523800,919,463,456
26,21,20,3523900,64,31,33
27,21,20,3524000,190,94,96
28,21,20,3524100,361,183,178
29,21,20,3524200,457,222,235
30,21,20,3524300,573,281,292
31,21,20,3524400,124,60,64
32,21,20,3524500,125,59,66
33,21,20,3524600,500,272,228
34,21,20,3524700,11,7,4
35,21,20,3524800,74,41,33
36,21,20,3524900,33,15,18
37,21,20,3525000,98,46,52
38,21,20,3525100,44,21,23
39,21,20,3525200,47,18,29
40,21,20,3525300,190,101,89
41,21,20,3525400,106,50,56
42,21,20,3525500,409,201,208
43,21,20,3525600,165,85,80
44,21,20,3525700,141,70,71
45,21,20,3525800,0,0,0
46,21,20,3525900,204,94,110
47,21,20,3526000,164,73,91
48,21,20,3526100,3093,1628,1465
49,21,20,3526200,330,168,162
50,21,20,3526300,105,52,53
51,21,20,3526400,233,119,114
52,21,20,3526500,491,227,264
53,21,20,3526600,131,63,68
54,21,20,3526700,90,44,46
55,21,20,3526800,259,123,136
56,21,20,3526900,494,232,262
57,21,20,3527000,328,149,179
58,21,20,3527100,194,98,96
59,21,20,3527200,80,35,45
60,21,20,3527300,259,130,129
61,21,20,3527400,487,217,270
62,21,20,3527500,0,0,0
63,21,20,3527600,105,51,54
64,21,20,3527700,116,60,56
65,21,20,3527800,190,92,98
66,21,20,3527900,35,16,19
67,21,20,3528000,4,2,2
68,21,20,3528100,72,35,37
69,21,20,3528200,404,194,210
70,21,20,3528300,28,15,13
71,21,20,3528400,351,168,183
72,21,20,3528500,123,59,64
73,21,20,3528600,295,142,153
74,21,20,3528700,171,81,90
75,21,20,3528800,100,46,54
76,21,20,3528900,312,141,171
77,21,20,3529000,239,118,121
78,21,20,3529100,169,72,97
79,21,20,3529200,71,32,39
80,21,20,3529300,430,191,239
81,21,20,3529400,193,89,104
82,21,20,3529500,0,0,0
83,21,20,3529600,386,178,208
84,21,20,3529700,163,77,86
85,21,20,3529800,120,60,60
86,21,20,3529900,217,102,115
87,21,20,3530000,173,76,97
88,21,20,3530100,365,193,172
89,21,20,3530200,365,182,183
90,21,20,3530300,1304,601,703
91,21,20,3530400,818,408,410
92,21,20,3530500,476,238,238
93,21,20,3530600,547,245,302
94,21,20,3530700,170,72,98
95,21,20,3530800,110,56,54
96,21,20,3530900,143,63,80
97,21,20,3531000,379,194,185
98,21,20,3531100,569,288,281
99,21,20,3531200,579,267,312
100,21,20,3531300,576,271,305
101,21,20,3531400,119,59,60
102,21,20,3531500,38,20,18
103,21,20,3531600,645,301,344
104,21,20,3531700,698,332,366
105,21,20,3531800,93,43,50
106,21,20,3531900,637,289,348
107,21,20,3532000,181,94,87
108,21,20,3532100,63,27,36
109,21,20,3532200,37,15,22
110,21,20,3532300,0,0,0
111,21,20,3532400,335,152,183
112,21,20,3370600,136,74,62
113,21,20,3370700,381,178,203
114,21,20,3370800,131,64,67
115,21,20,3370900,0,0,0
116,21,20,3371000,248,128,120
117,21,20,3371100,77,45,32
118,21,20,3371200,18,7,11
119,21,20,3371300,267,114,153
120,21,20,3371400,677,324,353
121,21,20,3371500,174,87,87
122,21,20,3371600,79,36,43
123,21,20,3371700,358,175,183
124,21,20,3371800,131,64,67
125,21,20,3371900,190,87,103
126,21,20,3372000,755,366,389
127,21,20,3372100,110,57,53
128,21,20,3372200,261,129,132
129,21,20,3372300,1115,644,471
130,21,20,3372400,785,375,410
131,21,20,3372500,534,265,269
132,21,20,3372600,196,102,94
133,21,20,3372700,0,0,0
134,21,20,3372800,339,162,177
135,21,20,3372900,126,65,61
136,21,20,3373000,0,0,0
137,21,20,3373100,199,95,104
138,21,20,3373200,134,62,72
139,21,20,3373300,163,92,71
140,21,20,3373400,64,31,33
141,21,20,3373500,51,22,29
142,21,20,3373600,193,105,88
143,21,20,3373700,105,54,51
144,21,20,3373800,250,123,127
145,21,20,3373900,549,270,279
146,21,20,3374000,52,26,26
147,21,20,3374100,99,42,57
148,21,20,3374200,250,123,127
149,21,20,3374300,33,20,13
150,21,20,3374400,115,55,60
151,21,20,3374500,47,22,25
152,21,20,3374600,149,70,79
153,21,20,3374700,196,92,104
154,21,20,3374800,55,24,31
155,21,20,3374900,0,0,0
156,21,20,3375000,0,0,0
157,21,20,3375100,0,0,0
158,21,20,3375200,65,32,33
159,21,20,3375300,1142,614,528
160,21,20,3375400,14,7,7
161,21,20,3375500,492,240,252
162,21,20,3375600,148,65,83
163,21,20,3375700,410,201,209
164,21,20,3375800,77,30,47
165,21,20,3375900,242,111,131
166,21,20,3376000,216,106,110
167,21,20,3376100,115,59,56
168,21,20,3376200,271,132,139
169,21,20,3376300,269,133,136
170,21,20,3376400,64,27,37
171,21,20,3376500,130,67,63
172,21,20,3376600,221,109,112
173,21,20,3376700,99,54,45
174,21,20,3376800,353,165,188
175,21,20,3376900,426,192,234
176,21,20,3377000,202,90,112
177,21,20,3377100,2966,1468,1498
178,21,20,3377200,276,145,131
179,21,20,3377300,0,0,0
180,21,20,3377400,104,55,49
181,21,20,3377500,298,150,148
182,21,20,3377600,0,0,0
183,21,20,3377700,53,26,27
184,21,20,3377800,193,98,95
185,21,20,3377900,213,108,105
186,21,20,3378000,189,91,98
187,21,20,3378100,267,114,153
188,21,20,3378200,400,175,225
189,21,20,3378300,71,36,35
190,21,20,3378400,433,210,223
191,21,20,3378500,105,56,49
192,21,20,3378600,405,198,207
193,21,20,3378700,248,134,114
194,21,20,3378800,384,185,199
195,21,20,3378900,207,104,103
196,21,20,3379000,34,20,14
197,21,20,3379100,312,143,169
198,21,20,3379200,119,52,67
199,21,20,3379300,121,53,68
200,21,20,3379400,27,15,12
201,21,20,3379500,90,35,55
202,21,20,3379600,86,42,44
203,21,20,3379700,357,192,165
204,21,20,3379800,0,0,0
205,21,20,3379900,121,72,49
206,21,20,3380000,139,70,69
207,21,20,3380100,2124,1177,947
208,21,20,3380200,172,81,91
209,21,20,3380300,216,109,107
210,21,20,3380400,304,128,176
211,21,20,3380500,612,287,325
212,21,20,3380600,335,153,182
213,21,20,3380700,93,49,44
214,21,20,3380800,69,31,38
215,21,20,3380900,44,22,22
216,21,20,3381000,139,69,70
217,21,20,3381100,599,278,321
218,21,20,3381200,80,40,40
219,21,20,3381300,96,31,65
220,21,20,3381400,366,189,177
221,21,20,3381500,174,80,94
222,21,20,3381600,302,161,141
223,21,20,3381700,3864,1984,1880
224,21,20,3381800,55,27,28
225,21,20,3381900,983,534,449
226,21,20,3382000,207,102,105
227,21,20,3382100,143,70,73
228,21,20,3382200,263,121,142
229,21,20,3382300,0,0,0
230,21,20,3382400,277,136,141
231,21,20,3382500,124,57,67
232,21,20,3382600,0,0,0
233,21,20,3382700,641,269,372
234,21,20,3382800,344,159,185
235,21,20,3382900,140,67,73
236,21,20,3383000,71,30,41
237,21,20,3383100,160,89,71
238,21,20,3383200,304,144,160
239,21,20,3383300,227,111,116
240,21,20,3383400,261,133,128
241,21,20,3383500,219,108,111
242,21,20,3383600,232,108,124
243,21,20,3383700,132,62,70
244,21,20,3383800,179,84,95
245,21,20,3383900,108,52,56
246,21,20,3384000,152,69,83
247,21,20,3384100,63,33,30
248,21,20,3384200,114,63,51
249,21,20,3384300,122,54,68
250,21,20,3384400,59,28,31
251,21,20,3384500,0,0,0
252,21,20,3384600,0,0,0
253,21,20,3384700,104,49,55
254,21,20,3384800,0,0,0
255,21,20,3384900,392,202,190
256,21,20,3385000,948,543,405
257,21,20,3385100,184,84,100
258,21,20,3385200,28,13,15
259,21,20,3385300,25,11,14
260,21,20,3385400,317,152,165
261,21,20,3385500,114,47,67
262,21,20,3385600,121,61,60
263,21,20,3385700,398,201,197
264,21,20,3385800,66,32,34
265,21,20,3385900,55,22,33
266,21,20,3386000,60,33,27
267,21,20,3386100,158,76,82
268,21,20,3386200,2,1,1
269,21,20,3386300,645,327,318
270,21,20,3386400,486,228,258
271,21,20,3386500,124,66,58
272,21,20,3386600,43,21,22
273,21,20,3386700,198,89,109
274,21,20,3386800,20,10,10
275,21,20,3386900,232,93,139
276,21,20,3387000,237,113,124
277,21,20,3387100,0,0,0
278,21,20,3387200,20,10,10
279,21,20,3387300,170,77,93
280,21,20,3387400,276,128,148
281,21,20,3387500,94,52,42
282,21,20,3387600,328,144,184
283,21,20,3387700,86,42,44
284,21,20,3387800,0,0,0
285,21,20,3387900,71,30,41
286,21,20,3388000,283,139,144
287,21,20,3388100,80,37,43
288,21,20,3388200,241,118,123
289,21,20,3388300,363,161,202
290,21,20,3388400,31,15,16
291,21,20,3388500,0,0,0
292,21,20,3388600,305,154,151
293,21,20,3388700,375,227,148
294,21,20,3388800,252,114,138
295,21,20,3388900,139,66,73
296,21,20,3389000,106,49,57
297,21,20,3389100,38,16,22
298,21,20,3389200,122,63,59
299,21,20,3389300,61,31,30
300,21,20,3389400,62,28,34
301,21,20,3389500,140,66,74
302,21,20,3389600,164,89,75
303,21,20,3389700,294,144,150
304,21,20,3389800,300,145,155
305,21,20,3389900,74,43,31
306,21,20,3390000,380,103,277
307,21,20,3390100,95,53,42
308,21,20,3390200,110,54,56
309,21,20,3390300,484,238,246
310,21,20,3390400,0,0,0
311,21,20,3390500,46,31,15
312,21,20,3390600,189,90,99
313,21,20,3390700,5,3,2
314,21,20,3390800,348,160,188
315,21,20,3390900,108,51,57
316,21,20,3391000,192,94,98
317,21,20,3391100,1246,567,679
318,21,20,3391200,45,27,18
319,21,20,3391300,298,147,151
320,21,20,3391400,188,93,95
321,21,20,3391500,206,109,97
322,21,20,3391600,130,57,73
323,21,20,3391700,554,296,258
324,21,20,3391800,86,38,48
325,21,20,3391900,267,129,138
326,21,20,3392000,140,72,68
327,21,20,3392100,1004,524,480
328,21,20,3392200,386,189,197
329,21,20,3392300,430,189,241
330,21,20,3392400,104,50,54
331,21,20,3392500,134,63,71
332,21,20,3392600,162,71,91
333,21,20,3392700,398,181,217
334,21,20,3392800,114,46,68
335,21,20,3392900,73,37,36
336,21,20,3393000,531,273,258
337,21,20,3393100,289,135,154
338,21,20,3393200,256,125,131
339,21,20,3393300,263,133,130
340,21,20,3393400,66,32,34
341,21,20,3393500,60,24,36
342,21,20,3393600,30,16,14
343,21,20,3393700,103,50,53
344,21,20,3393800,388,196,192
345,21,20,3393900,51,25,26
346,21,20,3394000,203,92,111
347,21,20,3394100,103,51,52
348,21,20,3394200,126,62,64
349,21,20,3394300,124,66,58
350,21,20,3394400,151,67,84
351,21,20,3394500,226,112,114
352,21,20,3394600,109,55,54
353,21,20,3394700,341,165,176
354,21,20,3394800,286,143,143
355,21,20,3394900,674,349,325
356,21,20,3395000,113,62,51
357,21,20,3395100,723,384,339
358,21,20,3395200,164,77,87
359,21,20,3395300,371,169,202
360,21,20,3395400,239,102,137
361,21,20,3395500,228,100,128
362,21,20,3395600,21,10,11
363,21,20,3395700,301,144,157
364,21,20,3395800,385,169,216
365,21,20,3395900,288,120,168
366,21,20,3396000,310,135,175
367,21,20,3396100,105,42,63
368,21,20,3396200,130,55,75
369,21,20,3396300,291,140,151
370,21,20,3396400,119,55,64
371,21,20,3396500,739,341,398
372,21,20,3396600,164,85,79
373,21,20,3396700,74,41,33
374,21,20,3396800,111,43,68
375,21,20,3396900,28,14,14
376,21,20,3397000,130,72,58
377,21,20,3397100,224,112,112
378,21,20,3397200,59,23,36
379,21,20,3397300,271,132,139
380,21,20,3397400,177,84,93
381,21,20,3397500,180,81,99
382,21,20,3397600,886,515,371
383,21,20,3397700,12,7,5
384,21,20,3397800,299,154,145
385,21,20,3397900,80,37,43
386,21,20,3398000,547,256,291
387,21,20,3398100,28,14,14
388,21,20,3398200,153,69,84
389,21,20,3398300,745,381,364
390,21,20,3398400,226,121,105
391,21,20,3398500,106,50,56
392,21,20,3398600,76,42,34
393,21,20,3398700,114,42,72
394,21,20,3398800,13,5,8
395,21,20,3398900,418,206,212
396,21,20,3399000,71,30,41
397,21,20,3399100,202,93,109
398,21,20,3399200,18,5,13
399,21,20,3399300,118,60,58
400,21,20,3399400,56,30,26
401,21,20,3399500,0,0,0
402,21,20,3399600,207,103,104
403,21,20,3399700,610,343,267
404,21,20,3399800,370,184,186
405,21,20,3399900,197,95,102
406,21,20,3400000,426,196,230
407,21,20,3400100,151,71,80
408,21,20,3400200,191,98,93
409,21,20,3400300,141,67,74
410,21,20,3400400,692,322,370
411,21,20,3400500,52,27,25
412,21,20,3400600,438,253,185
413,21,20,3400700,188,103,85
414,21,20,3400800,572,273,299
415,21,20,3400900,302,163,139
416,21,20,3401000,168,85,83
417,21,20,3401100,147,69,78
418,21,20,3401200,168,74,94
419,21,20,3401300,160,85,75
420,21,20,3401400,281,118,163
421,21,20,3401500,151,65,86
422,21,20,3401600,805,428,377
423,21,20,3401700,294,148,146
424,21,20,3401800,109,50,59
425,21,20,3401900,49,22,27
426,21,20,3402000,44,15,29
427,21,20,3402100,209,106,103
428,21,20,3402200,238,122,116
429,21,20,3402300,77,38,39
430,21,20,3402400,79,36,43
431,21,20,3402500,111,67,44
432,21,20,3402600,54,28,26
433,21,20,3402700,165,80,85
434,21,20,3402800,96,45,51
435,21,20,3402900,307,147,160
436,21,20,3403000,526,256,270
437,21,20,3403100,182,91,91
438,21,20,3403200,184,74,110
439,21,20,3403300,336,177,159
440,21,20,3403400,415,213,202
441,21,20,3403500,84,42,42
442,21,20,3403600,77,37,40
443,21,20,3403700,130,66,64
444,21,20,3403800,373,178,195
445,21,20,3403900,196,111,85
446,21,20,3404000,188,93,95
447,21,20,3404100,108,54,54
448,21,20,3404200,61,25,36
449,21,20,3404300,181,86,95
450,21,20,3404400,169,81,88
451,21,20,3404500,241,118,123
452,21,20,3404600,150,66,84
453,21,20,3404700,157,65,92
454,21,20,3404800,5299,2827,2472
455,21,20,3404900,98,47,51
456,21,20,3405000,106,49,57
457,21,20,3405100,70,34,36
458,21,20,3405200,111,45,66
459,21,20,3405300,56,28,28
460,21,20,3405400,230,101,129
461,21,20,3405500,202,95,107
462,21,20,3405600,91,33,58
463,21,20,3405700,55,25,30
464,21,20,3405800,120,46,74
465,21,20,3405900,376,177,199
466,21,20,3406000,124,50,74
467,21,20,3406100,306,139,167
468,21,20,3406200,315,140,175
469,21,20,3406300,49,24,25
470,21,20,3406400,140,69,71
471,21,20,3406500,295,144,151
472,21,20,3406600,466,232,234
473,21,20,3406700,0,0,0
474,21,20,3406800,67,35,32
475,21,20,3406900,530,250,280
476,21,20,3407000,53,26,27
477,21,20,3407100,79,32,47
478,21,20,3407200,67,26,41
479,21,20,3407300,175,84,91
480,21,20,3407400,555,281,274
481,21,20,3407500,38,18,20
482,21,20,3407600,461,230,231
483,21,20,3407700,40,20,20
484,21,20,3407800,339,189,150
485,21,20,3407900,172,81,91
486,21,20,3408000,312,152,160
487,21,20,3408100,83,40,43
488,21,20,3408200,268,121,147
489,21,20,3408300,149,56,93
490,21,20,3408400,91,43,48
491,21,20,3408500,601,298,303
492,21,20,3408600,171,89,82
493,21,20,3408700,337,161,176
494,21,20,3408800,256,132,124
495,21,20,3408900,194,104,90
496,21,20,3409000,75,37,38
497,21,20,3409100,61,25,36
498,21,20,3409200,0,0,0
499,21,20,3409300,87,46,41
500,21,20,3409400,277,133,144
501,21,20,3409500,94,38,56
502,21,20,3409600,134,53,81
503,21,20,3409700,618,306,312
504,21,20,3409800,76,36,40
505,21,20,3409900,30,14,16
506,21,20,3410000,64,25,39
507,21,20,3410100,119,62,57
508,21,20,3410200,209,89,120
509,21,20,3410300,302,160,142
510,21,20,3410400,354,173,181
511,21,20,3410500,15,7,8
512,21,20,3410600,55,31,24
513,21,20,3410700,91,40,51
514,21,20,3410800,0,0,0
515,21,20,3410900,227,122,105
516,21,20,3411000,0,0,0
517,21,20,3411100,104,54,50
518,21,20,3411200,96,43,53
519,21,20,3411300,62,26,36
520,21,20,3411400,51,26,25
521,21,20,3411500,74,41,33
522,21,20,3411600,45,18,27
523,21,20,3411700,103,60,43
524,21,20,3411800,413,198,215
525,21,20,3411900,94,45,49
526,21,20,3412000,25,15,10
527,21,20,3412100,34,20,14
528,21,20,3412200,17,6,11
529,21,20,3412300,53,30,23
530,21,20,3412400,108,52,56
531,21,20,3412500,219,105,114
532,21,20,3412600,439,221,218
533,21,20,3412700,503,252,251
534,21,20,3412800,296,124,172
535,21,20,3412900,2150,1215,935
536,21,20,3413000,234,113,121
537,21,20,3413100,87,37,50
538,21,20,3413200,183,84,99
539,21,20,3413300,197,99,98
540,21,20,3413400,220,120,100
541,21,20,3413500,64,33,31
542,21,20,3413600,168,76,92
543,21,20,3413700,143,72,71
544,21,20,3413800,112,60,52
545,21,20,3413900,131,61,70
546,21,20,3414000,592,286,306
547,21,20,3414100,84,42,42
548,21,20,3414200,40,17,23
549,21,20,3414300,0,0,0
550,21,20,3414400,79,38,41
551,21,20,3414500,436,207,229
552,21,20,3414600,72,32,40
553,21,20,3414700,209,100,109
554,21,20,3414800,422,198,224
555,21,20,3414900,327,177,150
556,21,20,3415000,198,94,104
557,21,20,3415100,283,157,126
558,21,20,3415200,415,213,202
559,21,20,3415300,318,163,155
560,21,20,3415400,103,49,54
561,21,20,3415500,493,248,245
562,21,20,3415600,92,45,47
563,21,20,3415700,106,55,51
564,21,20,3415800,180,89,91
565,21,20,3415900,526,260,266
566,21,20,3416000,249,121,128
567,21,20,3416100,328,171,157
568,21,20,3416200,514,255,259
569,21,20,3416300,111,55,56
570,21,20,3416400,148,70,78
571,21,20,3416500,104,50,54
572,21,20,3416600,384,159,225
573,21,20,3416700,41,16,25
574,21,20,3416800,75,38,37
575,21,20,3416900,122,66,56
576,21,20,3417000,131,62,69
577,21,20,3417100,316,150,166
578,21,20,3417200,530,300,230
579,21,20,3417300,132,62,70
580,21,20,3417400,190,98,92
581,21,20,3417500,131,71,60
582,21,20,3417600,428,220,208
583,21,20,3417700,347,173,174
584,21,20,3417800,3805,1839,1966
585,21,20,3417900,233,122,111
586,21,20,3418000,367,181,186
587,21,20,3418100,238,122,116
588,21,20,3418200,525,248,277
589,21,20,3418300,270,126,144
590,21,20,3418400,910,461,449
591,21,20,3418500,1270,598,672
592,21,20,3418600,96,41,55
593,21,20,3418700,476,236,240
594,21,20,3418800,1074,539,535
595,21,20,3418900,104,55,49
596,21,20,3419000,258,123,135
597,21,20,3419100,175,86,89
598,21,20,3419200,928,476,452
599,21,20,3419300,0,0,0
600,21,20,3419400,365,177,188
601,21,20,3419500,288,136,152
602,21,20,3419600,251,132,119
603,21,20,3419700,198,101,97
604,21,20,3419800,59,27,32
605,21,20,3419900,135,75,60
606,21,20,3420000,167,74,93
607,21,20,3420100,710,338,372
608,21,20,3420200,84,41,43
609,21,20,3420300,75,41,34
610,21,20,3420400,250,118,132
611,21,20,3420500,128,65,63
612,21,20,3420600,1194,584,610
613,21,20,3420700,0,0,0
614,21,20,3420800,545,245,300
615,21,20,3420900,140,67,73
616,21,20,3421000,135,60,75
617,21,20,3421100,434,214,220
618,21,20,3421200,96,46,50
619,21,20,3421300,667,318,349
620,21,20,3421400,175,91,84
621,21,20,3421500,343,194,149
622,21,20,3421600,120,59,61
623,21,20,3421700,173,83,90
624,21,20,3421800,232,124,108
625,21,20,3421900,222,115,107
626,21,20,3422000,239,109,130
627,21,20,3422100,388,200,188
628,21,20,3422200,434,203,231
629,21,20,3422300,253,144,109
630,21,20,3422400,388,182,206
631,21,20,3422500,52,25,27
632,21,20,3422600,164,73,91
633,21,20,3422700,723,367,356
634,21,20,3422800,175,73,102
635,21,20,3422900,74,31,43
636,21,20,3423000,404,199,205
637,21,20,3423100,109,50,59
638,21,20,3423200,110,51,59
639,21,20,3423300,122,63,59
640,21,20,3423400,216,105,111
641,21,20,3423500,283,141,142
642,21,20,3423600,1127,554,573
643,21,20,3423700,204,102,102
644,21,20,3423800,423,204,219
645,21,20,3423900,0,0,0
646,21,20,3424000,231,101,130
647,21,20,3424100,217,99,118
648,21,20,3424200,62,36,26
649,21,20,3424300,138,67,71
650,21,20,3424400,185,85,100
651,21,20,3424500,92,44,48
652,21,20,3424600,104,53,51
653,21,20,3424700,140,63,77
654,21,20,3424800,314,149,165
655,21,20,3424900,172,95,77
656,21,20,3425000,455,223,232
657,21,20,3425100,71,41,30
658,21,20,3425200,1256,603,653
659,21,20,3425300,517,361,156
660,21,20,3425400,196,98,98
661,21,20,3425500,218,111,107
662,21,20,3425600,85,44,41
663,21,20,3425700,0,0,0
664,21,20,3425800,668,336,332
665,21,20,3425900,34,16,18
666,21,20,3426000,64,28,36
667,21,20,3426100,2252,1148,1104
668,21,20,3426200,463,217,246
669,21,20,3426300,219,99,120
670,21,20,3426400,249,114,135
671,21,20,3426500,649,329,320
672,21,20,3426600,144,69,75
673,21,20,3426700,539,287,252
674,21,20,3426800,163,89,74
675,21,20,3426900,34,17,17
676,21,20,3427000,43,27,16
677,21,20,3427100,24,15,9
678,21,20,3427200,206,100,106
679,21,20,3427300,34,17,17
680,21,20,3427400,14,7,7
681,21,20,3427500,0,0,0
682,21,20,3427600,101,57,44
683,21,20,3427700,90,49,41
684,21,20,3427800,6,3,3
685,21,20,3427900,69,32,37
686,21,20,3428000,26,13,13
687,21,20,3428100,26,12,14
688,21,20,3428200,93,53,40
689,21,20,3428300,33,18,15
690,21,20,3428400,0,0,0
691,21,20,3428500,65,32,33
692,21,20,3428600,0,0,0
693,21,20,3428700,91,42,49
694,21,20,3428800,0,0,0
695,21,20,3428900,71,37,34
696,21,20,3429000,61,33,28
697,21,20,3429100,28,10,18
698,21,20,3429200,226,104,122
699,21,20,3429300,238,124,114
700,21,20,3429400,64,35,29
701,21,20,3429500,0,0,0
702,21,20,3429600,0,0,0
703,21,20,3429700,62,28,34
704,21,20,3429800,77,37,40
705,21,20,3429900,121,50,71
706,21,20,3430000,128,69,59
707,21,20,3430100,73,38,35
708,21,20,3430200,54,31,23
709,21,20,3430300,67,34,33
710,21,20,3430400,185,99,86
711,21,20,3430500,37,20,17
712,21,20,3430600,16,10,6
713,21,20,3430700,28,17,11
714,21,20,3430800,149,67,82
715,21,20,3430900,73,41,32
716,21,20,3431000,90,38,52
717,21,20,3431100,122,72,50
718,21,20,3431200,55,20,35
719,21,20,3431300,69,34,35
720,21,20,3431400,122,57,65
721,21,20,3431500,0,0,0
722,21,20,3431600,169,84,85
723,21,20,3431700,134,67,67
724,21,20,3431800,157,66,91
725,21,20,3431900,63,26,37
726,21,20,3432000,118,61,57
727,21,20,3432100,200,102,98
728,21,20,3432200,118,50,68
729,21,20,3432300,586,339,247
730,21,20,3432400,104,54,50
731,21,20,3432500,200,86,114
732,21,20,3432600,102,42,60
733,21,20,3432700,74,38,36
734,21,20,3432800,60,23,37
735,21,20,3432900,28,13,15
736,21,20,3433000,265,114,151
737,21,20,3433100,110,54,56
738,21,20,3433200,169,80,89
739,21,20,3433300,170,86,84
740,21,20,3433400,377,184,193
741,21,20,3433500,0,0,0
742,21,20,3433600,294,143,151
743,21,20,3433700,211,115,96
744,21,20,3433800,173,89,84
745,21,20,3433900,252,129,123
746,21,20,3434000,49,23,26
747,21,20,3434100,108,51,57
748,21,20,3434200,177,111,66
749,21,20,3434300,567,276,291
750,21,20,3434400,1270,644,626
751,21,20,3434500,0,0,0
752,21,20,3434600,119,53,66
753,21,20,3434700,184,83,101
754,21,20,3434800,222,100,122
755,21,20,3434900,222,104,118
756,21,20,3435000,132,57,75
757,21,20,3435100,0,0,0
758,21,20,3435200,393,190,203
759,21,20,3435300,148,74,74
760,21,20,3435400,506,223,283
761,21,20,3435500,371,170,201
762,21,20,3435600,120,61,59
763,21,20,3435700,604,294,310
764,21,20,3435800,112,46,66
765,21,20,3435900,276,136,140
766,21,20,3436000,132,56,76
767,21,20,3436100,267,126,141
768,21,20,3436200,189,85,104
769,21,20,3436300,273,148,125
770,21,20,3436400,294,114,180
771,21,20,3436500,523,250,273
772,21,20,3436600,341,163,178
773,21,20,3436700,400,183,217
774,21,20,3436800,139,67,72
775,21,20,3436900,86,38,48
776,21,20,3437000,410,197,213
777,21,20,3437100,0,0,0
778,21,20,3437200,111,55,56
779,21,20,3437300,314,148,166
780,21,20,3437400,896,445,451
781,21,20,3437500,475,238,237
782,21,20,3437600,37,17,20
783,21,20,3437700,203,109,94
784,21,20,3437800,13,7,6
785,21,20,3437900,61,28,33
786,21,20,3438000,229,118,111
787,21,20,3438100,246,120,126
788,21,20,3438200,70,38,32
789,21,20,3438300,2805,1423,1382
790,21,20,3438400,609,300,309
791,21,20,3438500,332,153,179
792,21,20,3438600,288,148,140
793,21,20,3438700,261,118,143
794,21,20,3438800,115,45,70
795,21,20,3438900,483,249,234
796,21,20,3439000,481,201,280
797,21,20,3439100,165,73,92
798,21,20,3439200,0,0,0
799,21,20,3439300,671,419,252
800,21,20,3439400,418,223,195
801,21,20,3439500,367,177,190
802,21,20,3439600,358,199,159
803,21,20,3439700,23,11,12
804,21,20,3439800,152,67,85
805,21,20,3439900,371,174,197
806,21,20,3440000,631,280,351
807,21,20,3440100,283,170,113
808,21,20,3440200,483,236,247
809,21,20,3440300,13,6,7
810,21,20,3440400,505,253,252
811,21,20,3440500,237,115,122
812,21,20,3440600,94,43,51
813,21,20,3440700,231,105,126
814,21,20,3440800,251,112,139
815,21,20,3440900,818,427,391
816,21,20,3441000,408,204,204
817,21,20,3441100,262,125,137
818,21,20,3441200,0,0,0
819,21,20,3441300,285,143,142
820,21,20,3441400,89,43,46
821,21,20,3441500,238,116,122
822,21,20,3441600,442,213,229
823,21,20,3441700,142,69,73
824,21,20,3441800,5059,2682,2377
825,21,20,3441900,447,228,219
826,21,20,3442000,272,139,133
827,21,20,3442100,0,0,0
828,21,20,3442200,124,55,69
829,21,20,3442300,345,183,162
830,21,20,3442400,888,512,376
831,21,20,3442500,131,70,61
832,21,20,3442600,365,169,196
833,21,20,3442700,245,119,126
834,21,20,3442800,121,57,64
835,21,20,3442900,281,139,142
836,21,20,3443000,260,115,145
837,21,20,3443100,266,130,136
838,21,20,3443200,588,259,329
839,21,20,3443300,308,164,144
840,21,20,3443400,5,3,2
841,21,20,3443500,123,53,70
842,21,20,3443600,206,92,114
843,21,20,3443700,104,54,50
844,21,20,3443800,99,44,55
845,21,20,3443900,157,69,88
846,21,20,3444000,16,8,8
847,21,20,3444100,273,123,150
848,21,20,3444200,349,165,184
849,21,20,3444300,322,129,193
850,21,20,3444400,141,66,75
851,21,20,3444500,712,371,341
852,21,20,3444600,51,23,28
853,21,20,3444700,556,256,300
854,21,20,3444800,174,74,100
855,21,20,3444900,188,94,94
856,21,20,3445000,123,54,69
857,21,20,3445100,96,42,54
858,21,20,3445200,103,51,52
859,21,20,3445300,202,89,113
860,21,20,3445400,64,31,33
861,21,20,3445500,28,12,16
862,21,20,3445600,87,46,41
863,21,20,3445700,273,132,141
864,21,20,3445800,390,204,186
865,21,20,3445900,252,134,118
866,21,20,3446000,2557,1320,1237
867,21,20,3446100,80,38,42
868,21,20,3446200,406,178,228
869,21,20,3446300,198,85,113
870,21,20,3446400,358,147,211
871,21,20,3446500,348,167,181
872,21,20,3446600,334,162,172
873,21,20,3446700,354,159,195
874,21,20,3446800,4,2,2
875,21,20,3446900,124,62,62
876,21,20,3447000,112,55,57
877,21,20,3447100,187,85,102
878,21,20,3447200,1398,718,680
879,21,20,3447300,134,65,69
880,21,20,3447400,613,278,335
881,21,20,3447500,0,0,0
882,21,20,3447600,253,121,132
883,21,20,3447700,221,111,110
884,21,20,3447800,277,135,142
885,21,20,3447900,0,0,0
886,21,20,3448000,934,412,522
887,21,20,3448100,57,26,31
888,21,20,3448200,642,311,331
889,21,20,3448300,358,203,155
890,21,20,3448400,266,126,140
891,21,20,3448500,461,211,250
892,21,20,3448600,106,52,54
893,21,20,3448700,251,130,121
894,21,20,3448800,153,69,84
895,21,20,3448900,457,217,240
896,21,20,3449000,211,91,120
897,21,20,3449100,177,81,96
898,21,20,3449200,82,28,54
899,21,20,3449300,150,67,83
900,21,20,3449400,132,54,78
901,21,20,3449500,585,268,317
902,21,20,3449600,92,37,55
903,21,20,3449700,143,69,74
904,21,20,3449800,138,69,69
905,21,20,3449900,160,67,93
906,21,20,3450000,194,87,107
907,21,20,3450100,220,101,119
908,21,20,3450200,238,119,119
909,21,20,3450300,196,102,94
910,21,20,3450400,213,104,109
911,21,20,3450500,257,111,146
912,21,20,3450600,281,144,137
913,21,20,3450700,125,54,71
914,21,20,3450800,171,86,85
915,21,20,3450900,374,179,195
916,21,20,3451000,300,150,150
917,21,20,3451100,249,132,117
918,21,20,3451200,442,190,252
919,21,20,3451300,76,38,38
920,21,20,3451400,464,216,248
921,21,20,3451500,23,10,13
922,21,20,3451600,0,0,0
923,21,20,3451700,280,144,136
924,21,20,3451800,154,82,72
925,21,20,3451900,85,41,44
926,21,20,3452000,55,28,27
927,21,20,3452100,309,149,160
928,21,20,3452200,72,27,45
929,21,20,3452300,280,125,155
930,21,20,3452400,38,25,13
931,21,20,3452500,50,21,29
932,21,20,3452600,25,14,11
933,21,20,3452700,0,0,0
934,21,20,3452800,67,32,35
935,21,20,3452900,84,42,42
936,21,20,3453000,44,23,21
937,21,20,3453100,52,24,28
938,21,20,3453200,50,22,28
939,21,20,3453300,136,61,75
940,21,20,3453400,18,6,12
941,21,20,3453500,86,37,49
942,21,20,3453600,201,120,81
943,21,20,3453700,120,57,63
944,21,20,3453800,89,40,49
945,21,20,3453900,933,599,334
946,21,20,3454000,304,125,179
947,21,20,3454100,158,76,82
948,21,20,3454200,220,102,118
949,21,20,3454300,12,5,7
950,21,20,3454400,232,109,123
951,21,20,3454500,56,28,28
952,21,20,3454600,129,63,66
953,21,20,3454700,179,94,85
954,21,20,3454800,412,203,209
955,21,20,3454900,149,66,83
956,21,20,3455000,100,47,53
957,21,20,3455100,177,86,91
958,21,20,3455200,348,170,178
959,21,20,3455300,338,161,177
960,21,20,3455400,383,178,205
961,21,20,3455500,435,228,207
962,21,20,3455600,155,79,76
963,21,20,3455700,70,36,34
964,21,20,3455800,216,93,123
965,21,20,3455900,238,120,118
966,21,20,3456000,154,81,73
967,21,20,3456100,90,47,43
968,21,20,3456200,61,31,30
969,21,20,3456300,54,25,29
970,21,20,3456400,139,59,80
971,21,20,3456500,11,6,5
972,21,20,3456600,94,42,52
973,21,20,3456700,89,46,43
974,21,20,3456800,203,93,110
975,21,20,3456900,131,69,62
976,21,20,3457000,182,98,84
977,21,20,3457100,0,0,0
978,21,20,3457200,251,133,118
979,21,20,3457300,159,79,80
980,21,20,3457400,80,44,36
981,21,20,3457500,185,77,108
982,21,20,3457600,230,100,130
983,21,20,3457700,57,25,32
984,21,20,3457800,376,179,197
985,21,20,3457900,170,77,93
986,21,20,3458000,595,281,314
987,21,20,3458100,0,0,0
988,21,20,3458200,400,168,232
989,21,20,3458300,232,104,128
990,21,20,3458400,2160,978,1182
991,21,20,3458500,273,125,148
992,21,20,3458600,322,159,163
993,21,20,3458700,152,67,85
994,21,20,3458800,570,350,220
995,21,20,3458900,243,113,130
996,21,20,3459000,252,113,139
997,21,20,3459100,605,280,325
998,21,20,3459200,702,334,368
999,21,20,3459300,257,122,135
1000,21,20,3459400,485,216,269
1001,21,20,3459500,0,0,0
1002,21,20,3459600,99,44,55
1003,21,20,3459700,163,90,73
1004,21,20,3459800,0,0,0
1005,21,20,3459900,786,399,387
1006,21,20,3460000,330,158,172
1007,21,20,3460100,795,404,391
1008,21,20,3460200,218,119,99
1009,21,20,3460300,461,230,231
1010,21,20,3460400,340,160,180
1011,21,20,3460500,0,0,0
1012,21,20,3460600,835,425,410
1013,21,20,3460700,672,345,327
1014,21,20,3460800,319,165,154
1015,21,20,3460900,90,47,43
1016,21,20,3461000,272,128,144
1017,21,20,3461100,1174,557,617
1018,21,20,3461200,18,11,7
1019,21,20,3461300,0,0,0
1020,21,20,3461400,356,161,195
1021,21,20,3461500,0,0,0
1022,21,20,3461600,0,0,0
1023,21,20,3461700,366,177,189
1024,21,20,3461800,1622,821,801
1025,21,20,3461900,880,408,472
1026,21,20,3462000,59,27,32
1027,21,20,3462100,131,59,72
1028,21,20,3462200,0,0,0
1029,21,20,3462300,0,0,0
1030,21,20,3462400,187,98,89
1031,21,20,3462500,51,22,29
1032,21,20,3462600,677,324,353
1033,21,20,3462700,218,113,105
1034,21,20,3462800,116,54,62
1035,21,20,3462900,315,141,174
1036,21,20,3463000,314,142,172
1037,21,20,3463100,132,71,61
1038,21,20,3463200,153,84,69
1039,21,20,3463300,91,44,47
1040,21,20,3463400,181,83,98
1041,21,20,3463500,418,196,222
1042,21,20,3463600,669,326,343
1043,21,20,3463700,51,28,23
1044,21,20,3463800,292,135,157
1045,21,20,3463900,6,1,5
1046,21,20,3464000,87,42,45
1047,21,20,3464100,621,301,320
1048,21,20,3464200,0,0,0
1049,21,20,3464300,0,0,0
1050,21,20,3464400,1375,720,655
1051,21,20,3464500,1171,555,616
1052,21,20,3464600,454,247,207
1053,21,20,3464700,455,238,217
1054,21,20,3464800,53,25,28
1055,21,20,3464900,514,265,249
1056,21,20,3465000,677,354,323
1057,21,20,3465100,502,242,260
1058,21,20,3465200,504,255,249
1059,21,20,3465300,196,90,106
1060,21,20,3465400,197,102,95
1061,21,20,3465500,172,90,82
1062,21,20,3465600,53,23,30
1063,21,20,3465700,292,143,149
1064,21,20,3465800,869,403,466
1065,21,20,3465900,543,268,275
1066,21,20,3466000,277,191,86
1067,21,20,3466100,1131,527,604
1068,21,20,3466200,589,295,294
1069,21,20,3466300,594,297,297
1070,21,20,3466400,74,37,37
1071,21,20,3466500,158,114,44
1072,21,20,3466600,3205,1546,1659
1073,21,20,3466700,0,0,0
1074,21,20,3466800,482,231,251
1075,21,20,3466900,0,0,0
1076,21,20,3467000,1817,894,923
1077,21,20,3467100,0,0,0
1078,21,20,3467200,150,67,83
1079,21,20,3467300,334,163,171
1080,21,20,3467400,283,128,155
1081,21,20,3467500,145,77,68
1082,21,20,3467600,188,93,95
1083,21,20,3467700,434,234,200
1084,21,20,3467800,0,0,0
1085,21,20,3467900,291,289,2
1086,21,20,3468000,0,0,0
1087,21,20,3468100,851,417,434
1088,21,20,3468200,547,277,270
1089,21,20,3468300,47,23,24
1090,21,20,3468400,2463,1167,1296
1091,21,20,3468500,115,54,61
1092,21,20,3468600,105,43,62
1093,21,20,3468700,108,53,55
1094,21,20,3468800,0,0,0
1095,21,20,3468900,84,44,40
1096,21,20,3469000,340,167,173
1097,21,20,3469100,698,318,380
1098,21,20,3469200,840,416,424
1099,21,20,3469300,512,246,266
1100,21,20,3469400,595,288,307
1101,21,20,3469500,810,422,388
1102,21,20,3469600,79,35,44
1103,21,20,3469700,206,100,106
1104,21,20,3469800,85,35,50
1105,21,20,3469900,444,214,230
1106,21,20,3470000,355,179,176
1107,21,20,3470100,128,70,58
1108,21,20,3470200,964,465,499
1109,21,20,3470300,213,112,101
1110,21,20,3470400,1133,559,574
1111,21,20,3470500,393,184,209
1112,21,20,3470600,227,109,118
1113,21,20,3470700,1102,543,559
1114,21,20,3470800,1227,583,644
1115,21,20,3470900,102,50,52
1116,21,20,3471000,109,56,53
1117,21,20,3471100,90,38,52
1118,21,20,3471200,128,63,65
1119,21,20,3471300,212,103,109
1120,21,20,3471400,947,477,470
1121,21,20,3471500,824,408,416
1122,21,20,3471600,750,380,370
1123,21,20,3471700,13,5,8
1124,21,20,3471800,1157,537,620
1125,21,20,3471900,2319,1072,1247
1126,21,20,3472000,386,191,195
1127,21,20,3472100,2371,1200,1171
1128,21,20,3472200,181,94,87
1129,21,20,3472300,0,0,0
1130,21,20,3472400,1295,623,672
1131,21,20,3472500,775,380,395
1132,21,20,3472600,1476,697,779
1133,21,20,3472700,581,276,305
1134,21,20,3472800,2455,1216,1239
1135,21,20,3472900,491,234,257
1136,21,20,3473000,981,494,487
1137,21,20,3473100,814,399,415
1138,21,20,3473200,1434,723,711
1139,21,20,3473300,1059,515,544
1140,21,20,3473400,596,298,298
1141,21,20,3473500,0,0,0
1142,21,20,3473600,357,177,180
1143,21,20,3473700,0,0,0
1144,21,20,3473800,0,0,0
1145,21,20,3473900,1918,991,927
1146,21,20,3474000,486,242,244
1147,21,20,3474100,0,0,0
1148,21,20,3474200,1533,790,743
1149,21,20,3474300,275,135,140
1150,21,20,3474400,420,189,231
1151,21,20,3474500,707,348,359
1152,21,20,3474600,633,325,308
1153,21,20,3474700,138,65,73
1154,21,20,3474800,0,0,0
1155,21,20,3474900,1083,527,556
1156,21,20,3475000,466,236,230
1157,21,20,3475100,1564,776,788
1158,21,20,3475200,801,397,404
1159,21,20,3475300,1858,921,937
1160,21,20,3475400,1121,534,587
1161,21,20,3475500,1387,667,720
1162,21,20,3475600,307,151,156
1163,21,20,3475700,1159,589,570
1164,21,20,3475800,416,202,214
1165,21,20,3475900,169,85,84
1166,21,20,3476000,821,392,429
1167,21,20,3476100,750,354,396
1168,21,20,3476200,554,286,268
1169,21,20,3476300,966,477,489
1170,21,20,3476400,3706,1819,1887
1171,21,20,3476500,579,291,288
1172,21,20,3476600,573,291,282
1173,21,20,3476700,66,30,36
1174,21,20,3476800,514,249,265
1175,21,20,3476900,227,115,112
1176,21,20,3477000,540,263,277
1177,21,20,3477100,671,343,328
1178,21,20,3477200,0,0,0
1179,21,20,3477300,288,141,147
1180,21,20,3477400,0,0,0
1181,21,20,3477500,1054,510,544
1182,21,20,3477600,0,0,0
1183,21,20,3477700,1458,723,735
1184,21,20,3477800,973,467,506
1185,21,20,3477900,0,0,0
1186,21,20,3478000,2508,1209,1299
1187,21,20,3478100,0,0,0
1188,21,20,3478200,598,290,308
1189,21,20,3478300,1642,804,838
1190,21,20,3478400,1640,818,822
1191,21,20,3478500,941,468,473
1192,21,20,3478600,753,374,379
1193,21,20,3478700,185,103,82
1194,21,20,3478800,0,0,0
1195,21,20,3478900,324,153,171
1196,21,20,3479000,308,149,159
1197,21,20,3479100,523,260,263
1198,21,20,3479200,527,262,265
1199,21,20,3479300,0,0,0
1200,21,20,3479400,135,75,60
1201,21,20,3479500,253,134,119
1202,21,20,3479600,18,8,10
1203,21,20,3479700,542,249,293
1204,21,20,3479800,540,253,287
1205,21,20,3479900,0,0,0
1206,21,20,3480000,430,217,213
1207,21,20,3480100,355,168,187
1208,21,20,3480200,27,12,15
1209,21,20,3480300,493,246,247
1210,21,20,3480400,749,378,371
1211,21,20,3480500,1061,491,570
1212,21,20,3480600,163,87,76
1213,21,20,3480700,847,414,433
1214,21,20,3480800,120,55,65
1215,21,20,3480900,841,400,441
1216,21,20,3481000,62,36,26
1217,21,20,3481100,0,0,0
1218,21,20,3481200,922,445,477
1219,21,20,3481300,219,91,128
1220,21,20,3481400,191,93,98
1221,21,20,3481500,447,233,214
1222,21,20,3481600,0,0,0
1223,21,20,3481700,358,180,178
1224,21,20,3481800,1217,594,623
1225,21,20,3481900,40,21,19
1226,21,20,3482000,394,199,195
1227,21,20,3482100,0,0,0
1228,21,20,3482200,0,0,0
1229,21,20,3482300,0,0,0
1230,21,20,3482400,1575,791,784
1231,21,20,3482500,0,0,0
1232,21,20,3482600,432,218,214
1233,21,20,3482700,291,151,140
1234,21,20,3482800,0,0,0
1235,21,20,3482900,131,65,66
1236,21,20,3483000,353,173,180
1237,21,20,3483100,126,50,76
1238,21,20,3483200,113,56,57
1239,21,20,3483300,140,71,69
1240,21,20,3483400,1376,708,668
1241,21,20,3483500,864,434,430
1242,21,20,3483600,1776,883,893
1243,21,20,3483700,481,236,245
1244,21,20,3483800,358,177,181
1245,21,20,3483900,455,213,242
1246,21,20,3484000,226,115,111
1247,21,20,3484100,459,228,231
1248,21,20,3484200,423,202,221
1249,21,20,3484300,231,118,113
1250,21,20,3484400,345,144,201
1251,21,20,3484500,173,76,97
1252,21,20,3484600,150,69,81
1253,21,20,3484700,997,491,506
1254,21,20,3484800,714,344,370
1255,21,20,3484900,361,171,190
1256,21,20,3485000,272,140,132
1257,21,20,3485100,221,122,99
1258,21,20,3485200,872,457,415
1259,21,20,3485300,269,135,134
1260,21,20,3485400,1523,778,745
1261,21,20,3485500,1197,594,603
1262,21,20,3485600,65,36,29
1263,21,20,3485700,2770,1403,1367
1264,21,20,3485800,808,396,412
1265,21,20,3485900,310,151,159
1266,21,20,3486000,321,158,163
1267,21,20,3486100,54,25,29
1268,21,20,3486200,0,0,0
1269,21,20,3486300,145,71,74
1270,21,20,3486400,100,41,59
1271,21,20,3486500,61,22,39
1272,21,20,3486600,627,272,355
1273,21,20,3486700,525,257,268
1274,21,20,3486800,298,144,154
1275,21,20,3486900,91,32,59
1276,21,20,3487000,285,140,145
1277,21,20,3487100,755,420,335
1278,21,20,3487200,116,55,61
1279,21,20,3487300,231,106,125
1280,21,20,3487400,112,46,66
1281,21,20,3487500,283,133,150
1282,21,20,3487600,0,0,0
1283,21,20,3487700,383,298,85
1284,21,20,3487800,53,26,27
1285,21,20,3487900,27,17,10
1286,21,20,3488000,0,0,0
1287,21,20,3488100,111,61,50
1288,21,20,3488200,0,0,0
1289,21,20,3488300,1079,618,461
1290,21,20,3488400,71,36,35
1291,21,20,3488500,0,0,0
1292,21,20,3488600,100,40,60
1293,21,20,3488700,243,101,142
1294,21,20,3488800,60,28,32
1295,21,20,3488900,168,77,91
1296,21,20,3489000,511,221,290
1297,21,20,3489100,2402,1178,1224
1298,21,20,3489200,76,21,55
1299,21,20,3489300,1296,643,653
1300,21,20,3489400,15,6,9
1301,21,20,3489500,111,53,58
1302,21,20,3489600,246,115,131
1303,21,20,3489700,395,184,211
1304,21,20,3489800,105,59,46
1305,21,20,3489900,61,26,35
1306,21,20,3490000,236,96,140
1307,21,20,3490100,160,82,78
1308,21,20,3490200,90,35,55
1309,21,20,3490300,221,86,135
1310,21,20,3490400,60,33,27
1311,21,20,3490500,279,123,156
1312,21,20,3490600,266,131,135
1313,21,20,3490700,102,47,55
1314,21,20,3490800,145,73,72
1315,21,20,3490900,131,64,67
1316,21,20,3491000,332,158,174
1317,21,20,3491100,87,44,43
1318,21,20,3491200,769,321,448
1319,21,20,3491300,151,69,82
1320,21,20,3491400,134,67,67
1321,21,20,3491500,159,74,85
1322,21,20,3491600,89,43,46
1323,21,20,3491700,37,16,21
1324,21,20,3491800,86,33,53
1325,21,20,3491900,65,28,37
1326,21,20,3492000,36,13,23
1327,21,20,3492100,136,60,76
1328,21,20,3492200,160,81,79
1329,21,20,3492300,296,142,154
1330,21,20,3492400,66,31,35
1331,21,20,3492500,283,132,151
1332,21,20,3492600,510,245,265
1333,21,20,3492700,1170,647,523
1334,21,20,3492800,27,15,12
1335,21,20,3492900,124,63,61
1336,21,20,3493000,109,56,53
1337,21,20,3493100,490,237,253
1338,21,20,3493200,91,49,42
1339,21,20,3493300,163,81,82
1340,21,20,3493400,77,27,50
1341,21,20,3493500,498,241,257
1342,21,20,3493600,189,81,108
1343,21,20,3493700,160,71,89
1344,21,20,3493800,339,148,191
1345,21,20,3493900,110,55,55
1346,21,20,3494000,196,90,106
1347,21,20,3494100,89,34,55
1348,21,20,3494200,153,66,87
1349,21,20,3494300,0,0,0
1350,21,20,3494400,202,96,106
1351,21,20,3494500,31,15,16
1352,21,20,3494600,67,27,40
1353,21,20,3494700,164,81,83
1354,21,20,3494800,432,203,229
1355,21,20,3494900,52,23,29
1356,21,20,3495000,92,41,51
1357,21,20,3495100,42,24,18
1358,21,20,3495200,98,44,54
1359,21,20,3495300,73,31,42
1360,21,20,3495400,73,36,37
1361,21,20,3495500,161,75,86
1362,21,20,3495600,226,86,140
1363,21,20,3495700,1064,590,474
1364,21,20,3495800,2523,1272,1251
1365,21,20,3495900,0,0,0
1366,21,20,3496000,145,71,74
1367,21,20,3496100,318,151,167
1368,21,20,3496200,80,31,49
1369,21,20,3496300,153,99,54
1370,21,20,3496400,28,12,16
1371,21,20,3496500,374,177,197
1372,21,20,3496600,295,145,150
1373,21,20,3496700,73,36,37
1374,21,20,3496800,61,28,33
1375,21,20,3496900,144,70,74
1376,21,20,3497000,167,82,85
1377,21,20,3497100,24,13,11
1378,21,20,3497200,404,185,219
1379,21,20,3497300,134,66,68
1380,21,20,3497400,43,17,26
1381,21,20,3497500,196,76,120
1382,21,20,3497600,305,145,160
1383,21,20,3497700,43,20,23
1384,21,20,3497800,106,47,59
1385,21,20,3497900,977,459,518
1386,21,20,3498000,223,101,122
1387,21,20,3498100,147,70,77
1388,21,20,3498200,91,44,47
1389,21,20,3498300,412,187,225
1390,21,20,3498400,381,178,203
1391,21,20,3498500,226,105,121
1392,21,20,3498600,147,73,74
1393,21,20,3498700,81,32,49
1394,21,20,3498800,60,28,32
1395,21,20,3498900,135,64,71
1396,21,20,3499000,779,385,394
1397,21,20,3499100,882,419,463
1398,21,20,3499200,115,61,54
1399,21,20,3499300,192,96,96
1400,21,20,3499400,250,126,124
1401,21,20,3499500,119,59,60
1402,21,20,3499600,178,83,95
1403,21,20,3499700,3410,1689,1721
1404,21,20,3499800,312,126,186
1405,21,20,3499900,437,189,248
1406,21,20,3500000,311,159,152
1407,21,20,3500100,801,384,417
1408,21,20,3500200,337,173,164
1409,21,20,3500300,217,98,119
1410,21,20,3500400,204,86,118
1411,21,20,3500500,317,136,181
1412,21,20,3500600,799,405,394
1413,21,20,3500700,180,73,107
1414,21,20,3500800,263,121,142
1415,21,20,3500900,159,80,79
1416,21,20,3501000,105,51,54
1417,21,20,3501100,609,203,406
1418,21,20,3501200,64,26,38
1419,21,20,3501300,208,102,106
1420,21,20,3501400,0,0,0
1421,21,20,3501500,310,143,167
1422,21,20,3501600,959,456,503
1423,21,20,3501700,553,289,264
1424,21,20,3501800,151,65,86
1425,21,20,3501900,85,45,40
1426,21,20,3502000,329,148,181
1427,21,20,3502100,0,0,0
1428,21,20,3502200,358,151,207
1429,21,20,3502300,363,161,202
1430,21,20,3502400,768,356,412
1431,21,20,3502500,105,47,58
1432,21,20,3502600,45,18,27
1433,21,20,3502700,270,128,142
1434,21,20,3502800,21,12,9
1435,21,20,3502900,1632,844,788
1436,21,20,3503000,272,130,142
1437,21,20,3503100,462,211,251
1438,21,20,3503200,194,91,103
1439,21,20,3503300,38,17,21
1440,21,20,3503400,714,319,395
1441,21,20,3503500,61,22,39
1442,21,20,3503600,121,52,69
1443,21,20,3503700,290,125,165
1444,21,20,3503800,90,40,50
1445,21,20,3503900,105,53,52
1446,21,20,3504000,403,190,213
1447,21,20,3504100,212,102,110
1448,21,20,3504200,522,252,270
1449,21,20,3504300,562,253,309
1450,21,20,3504400,397,199,198
1451,21,20,3504500,454,223,231
1452,21,20,3504600,1316,753,563
1453,21,20,3504700,296,138,158
1454,21,20,3504800,412,203,209
1455,21,20,3504900,505,246,259
1456,21,20,3505000,231,95,136
1457,21,20,3505100,648,300,348
1458,21,20,3505200,99,44,55
1459,21,20,3505300,0,0,0
1460,21,20,3505400,543,265,278
1461,21,20,3505500,1331,629,702
1462,21,20,3505600,346,157,189
1463,21,20,3505700,220,101,119
1464,21,20,3505800,253,105,148
1465,21,20,3505900,290,131,159
1466,21,20,3506000,926,393,533
1467,21,20,3506100,317,142,175
1468,21,20,3506200,236,111,125
1469,21,20,3506300,451,201,250
1470,21,20,3506400,627,301,326
1471,21,20,3506500,657,296,361
1472,21,20,3506600,409,194,215
1473,21,20,3506700,327,155,172
1474,21,20,3506800,452,222,230
1475,21,20,3506900,307,168,139
1476,21,20,3507000,640,327,313
1477,21,20,3507100,70,38,32
1478,21,20,3507200,8,5,3
1479,21,20,3507300,175,82,93
1480,21,20,3507400,627,287,340
1481,21,20,3507500,179,87,92
1482,21,20,3507600,63,26,37
1483,21,20,3507700,239,110,129
1484,21,20,3507800,441,203,238
1485,21,20,3507900,56,27,29
1486,21,20,3508000,259,130,129
1487,21,20,3508100,839,407,432
1488,21,20,3508200,224,113,111
1489,21,20,3508300,946,502,444
1490,21,20,3508400,0,0,0
1491,21,20,3508500,918,446,472
1492,21,20,3508600,126,57,69
1493,21,20,3508700,163,81,82
1494,21,20,3508800,400,198,202
1495,21,20,3508900,363,165,198
1496,21,20,3509000,0,0,0
1497,21,20,3509100,36,16,20
1498,21,20,3509200,439,212,227
1499,21,20,3509300,1020,486,534
1500,21,20,3509400,125,57,68
1501,21,20,3509500,119,44,75
1502,21,20,3509600,251,89,162
1503,21,20,3509700,266,129,137
1504,21,20,3509800,368,170,198
1505,21,20,3509900,287,132,155
1506,21,20,3510000,113,61,52
1507,21,20,3510100,115,51,64
1508,21,20,3510200,524,251,273
1509,21,20,3510300,1144,514,630
1510,21,20,3510400,763,369,394
1511,21,20,3510500,167,83,84
1512,21,20,3510600,143,69,74
1513,21,20,3510700,82,44,38
1514,21,20,3510800,59,31,28
1515,21,20,3510900,162,70,92
1516,21,20,3511000,301,143,158
1517,21,20,3511100,0,0,0
1518,21,20,3511200,815,387,428
1519,21,20,3511300,1200,581,619
1520,21,20,3511400,315,138,177
1521,21,20,3511500,241,121,120
1522,21,20,3511600,586,300,286
1523,21,20,3511700,559,270,289
1524,21,20,3511800,269,126,143
1525,21,20,3511900,140,71,69
1526,21,20,3512000,719,335,384
1527,21,20,3512100,170,76,94
1528,21,20,3512200,0,0,0
1529,21,20,3512300,262,122,140
1530,21,20,3512400,175,80,95
1531,21,20,3512500,1330,652,678
1532,21,20,3512600,221,114,107
1533,21,20,3512700,135,69,66
1534,21,20,3512800,1353,661,692
1535,21,20,3512900,291,130,161
1536,21,20,3513000,239,106,133
1537,21,20,3513100,741,343,398
1538,21,20,3513200,98,54,44
1539,21,20,3513300,233,110,123
1540,21,20,3513400,4740,2543,2197
1541,21,20,3513500,292,131,161
1542,21,20,3513600,228,118,110
1543,21,20,3513700,874,408,466
1544,21,20,3513800,428,201,227
1545,21,20,3513900,119,55,64
1546,21,20,3514000,52,24,28
1547,21,20,3514100,1881,915,966
1548,21,20,3514200,182,89,93
1549,21,20,3514300,182,80,102
1550,21,20,3514400,54,26,28
1551,21,20,3514500,289,148,141
1552,21,20,3514600,229,132,97
1553,21,20,3514700,459,232,227
1554,21,20,3514800,897,469,428
1555,21,20,3514900,455,237,218
1556,21,20,3515000,420,181,239
1557,21,20,3515100,24,7,17
1558,21,20,3515200,320,67,253
1559,21,20,3515300,92,43,49
1560,21,20,3515400,305,147,158
1561,21,20,3515500,145,72,73
1562,21,20,3515600,465,228,237
1563,21,20,3515700,495,231,264
1564,21,20,3515800,0,0,0
1565,21,20,3515900,152,62,90
1566,21,20,3516000,354,175,179
1567,21,20,3516100,100,43,57
1568,21,20,3516200,203,96,107
1569,21,20,3516300,0,0,0
1570,21,20,3516400,222,115,107
1571,21,20,3516500,151,81,70
1572,21,20,3516600,49,20,29
1573,21,20,3516700,866,378,488
1574,21,20,3516800,319,138,181
1575,21,20,3516900,208,100,108
1576,21,20,3517000,28,11,17
1577,21,20,3517100,707,360,347
1578,21,20,3517200,59,28,31
1579,21,20,3517300,1170,570,600
1580,21,20,3517400,308,135,173
1581,21,20,3517500,398,199,199
1582,21,20,3517600,114,55,59
1583,21,20,3517700,136,57,79
1584,21,20,3517800,27,11,16
1585,21,20,3517900,83,41,42
1586,21,20,3518000,187,87,100
1587,21,20,3518100,56,25,31
1588,21,20,3518200,150,72,78
1589,21,20,3518300,110,50,60
1590,21,20,3518400,334,151,183
1591,21,20,3518500,24,14,10
1592,21,20,3518600,292,135,157
1593,21,20,3518700,592,308,284
1594,21,20,3518800,326,157,169
1595,21,20,3518900,331,160,171
1596,21,20,3519000,0,0,0
1597,21,20,3519100,81,32,49
1598,21,20,3519200,197,77,120
1599,21,20,3519300,491,243,248
1600,21,20,3519400,1982,980,1002
1601,21,20,3519500,25,13,12
1602,21,20,3519600,124,64,60
1603,21,20,3519700,231,115,116
1604,21,20,3519800,585,269,316
1605,21,20,3519900,471,233,238
1606,21,20,3520000,198,96,102
1607,21,20,3520100,32,15,17
1608,21,20,3520200,2258,1102,1156
1609,21,20,3520300,698,367,331
1610,21,20,3520400,201,93,108
1611,21,20,3520500,196,123,73
1612,21,20,3520600,17,8,9
1613,21,20,3520700,109,60,49
1614,21,20,3520800,297,164,133
1615,21,20,3520900,62,30,32
1616,21,20,3521000,17,6,11
1617,21,20,3521100,46,23,23
1618,21,20,3521200,65,32,33
