,Statecode,Districtcode,VillageCode,Population,Males,Females
0,21,26,4247300,3516,1735,1781
1,21,26,4247400,2354,1148,1206
2,21,26,4247500,2826,1406,1420
3,21,26,4247600,3675,1843,1832
4,21,26,4247700,2996,1521,1475
5,21,26,4247800,775,379,396
6,21,26,4247900,2194,1112,1082
7,21,26,4248000,3779,1890,1889
8,21,26,4248100,2777,1393,1384
9,21,26,4248200,1679,860,819
10,21,26,4248300,551,258,293
11,21,26,4248400,3701,1820,1881
12,21,26,4248500,1307,636,671
13,21,26,4248600,245,121,124
14,21,26,4248700,5842,2906,2936
15,21,26,4248800,1103,547,556
16,21,26,4248900,848,423,425
17,21,26,4249000,3184,1569,1615
18,21,26,4249100,1152,592,560
19,21,26,4249200,1242,605,637
20,21,26,4249300,975,478,497
21,21,26,4249400,2692,1351,1341
22,21,26,4249500,1529,761,768
23,21,26,4249600,374,198,176
24,21,26,4249700,981,480,501
25,21,26,4249800,446,212,234
26,21,26,4249900,1459,721,738
27,21,26,4250000,0,0,0
28,21,26,4250100,1534,775,759
29,21,26,4250200,1037,511,526
30,21,26,4250300,1497,730,767
31,21,26,4250400,1194,589,605
32,21,26,4250500,743,369,374
33,21,26,4250600,1180,579,601
34,21,26,4250700,5793,2857,2936
35,21,26,4250800,3051,1533,1518
36,21,26,4250900,1624,845,779
37,21,26,4251000,1559,765,794
38,21,26,4251100,1176,572,604
39,21,26,4251200,893,452,441
40,21,26,4251300,655,316,339
41,21,26,4251400,329,160,169
42,21,26,4251500,3219,1537,1682
43,21,26,4251600,879,417,462
44,21,26,4251700,1993,989,1004
45,21,26,4251800,41,18,23
46,21,26,4251900,1436,698,738
47,21,26,4252000,294,148,146
48,21,26,4252100,2746,1381,1365
49,21,26,4252200,1559,778,781
50,21,26,4252300,3401,1721,1680
51,21,26,4252400,4387,2243,2144
52,21,26,4252500,1264,613,651
53,21,26,4252600,3431,1706,1725
54,21,26,4252700,453,225,228
55,21,26,4252800,2186,1073,1113
56,21,26,4252900,2572,1268,1304
57,21,26,4253000,518,264,254
58,21,26,4253100,1605,772,833
59,21,26,4253200,2092,1067,1025
60,21,26,4253300,663,336,327
61,21,26,4253400,1214,598,616
62,21,26,4253500,1043,506,537
63,21,26,4253600,284,145,139
64,21,26,4253700,1287,634,653
65,21,26,4253800,812,390,422
66,21,26,4253900,852,425,427
67,21,26,4254000,3549,1733,1816
68,21,26,4254100,1938,946,992
69,21,26,4254200,2760,1370,1390
70,21,26,4254300,1403,688,715
71,21,26,4254400,2035,1007,1028
72,21,26,4254500,1615,821,794
73,21,26,4254600,6732,3395,3337
74,21,26,4254700,425,201,224
75,21,26,4254800,1416,716,700
76,21,26,4254900,1802,897,905
77,21,26,4255000,4867,2409,2458
78,21,26,4255100,1036,513,523
79,21,26,4255200,1956,948,1008
80,21,26,4255300,2119,1055,1064
81,21,26,4255400,1956,987,969
82,21,26,4255500,2412,1189,1223
83,21,26,4255600,6580,3244,3336
84,21,26,4255700,0,0,0
85,21,26,4255800,281,135,146
86,21,26,4255900,644,305,339
87,21,26,4256000,367,177,190
88,21,26,4256100,2973,1475,1498
89,21,26,4256200,931,471,460
90,21,26,4256300,1743,897,846
91,21,26,4256400,1036,497,539
92,21,26,4256500,965,482,483
93,21,26,4256600,5288,2757,2531
94,21,26,4256700,1622,808,814
95,21,26,4256800,479,246,233
96,21,26,4256900,491,219,272
97,21,26,4257000,170,85,85
98,21,26,4257100,11,7,4
99,21,26,4257200,711,350,361
100,21,26,4257300,621,292,329
101,21,26,4257400,73,38,35
102,21,26,4257500,443,229,214
103,21,26,4257600,1730,827,903
104,21,26,4257700,321,164,157
105,21,26,4257800,223,106,117
106,21,26,4257900,1475,736,739
107,21,26,4258000,792,390,402
108,21,26,4258100,270,139,131
109,21,26,4258200,3888,1963,1925
110,21,26,4258300,690,340,350
111,21,26,4258400,1697,902,795
112,21,26,4258500,1011,507,504
113,21,26,4258600,850,415,435
114,21,26,4258700,1661,847,814
115,21,26,4258800,998,525,473
116,21,26,4258900,1578,789,789
117,21,26,4259000,2865,1421,1444
118,21,26,4259100,896,445,451
119,21,26,4259200,2016,1015,1001
120,21,26,4259300,1268,649,619
121,21,26,4259400,720,362,358
122,21,26,4259500,912,467,445
123,21,26,4259600,1109,584,525
124,21,26,4259700,1704,887,817
125,21,26,4259800,1722,892,830
126,21,26,4259900,1650,833,817
127,21,26,4260000,1467,730,737
128,21,26,4260100,1113,531,582
129,21,26,4260200,968,491,477
130,21,26,4260300,1309,660,649
131,21,26,4260400,644,325,319
132,21,26,4260500,609,292,317
133,21,26,4260600,1211,623,588
134,21,26,4260700,4146,2205,1941
135,21,26,4260800,1725,860,865
136,21,26,4260900,1197,606,591
137,21,26,4261000,2311,1196,1115
138,21,26,4261100,3245,1635,1610
139,21,26,4261200,2484,1258,1226
140,21,26,4261300,2605,1340,1265
141,21,26,4261400,1841,937,904
142,21,26,4261500,532,266,266
143,21,26,4261600,2185,1107,1078
144,21,26,4261700,7445,3713,3732
145,21,26,4261800,4727,2378,2349
146,21,26,4261900,1720,874,846
147,21,26,4262000,3159,1605,1554
148,21,26,4262100,880,454,426
149,21,26,4262200,1572,789,783
150,21,26,4262300,1913,970,943
151,21,26,4262400,1350,669,681
152,21,26,4262500,1396,697,699
153,21,26,4262600,2684,1387,1297
154,21,26,4262700,1995,1016,979
155,21,26,4262800,990,499,491
156,21,26,4262900,1222,618,604
157,21,26,4263000,985,492,493
158,21,26,4263100,644,343,301
159,21,26,4263200,2487,1281,1206
160,21,26,4263300,4374,2202,2172
161,21,26,4263400,955,475,480
162,21,26,4263500,3152,1583,1569
163,21,26,4263600,1261,616,645
164,21,26,4263700,1918,955,963
165,21,26,4263800,2614,1271,1343
166,21,26,4263900,1145,565,580
167,21,26,4264000,3365,1645,1720
168,21,26,4264100,2263,1105,1158
169,21,26,4264200,480,234,246
170,21,26,4264300,1347,683,664
171,21,26,4264400,3183,1578,1605
172,21,26,4264500,335,165,170
173,21,26,4264600,400,214,186
174,21,26,4264700,828,393,435
175,21,26,4264800,956,493,463
176,21,26,4264900,1412,722,690
177,21,26,4265000,775,371,404
178,21,26,4265100,1291,643,648
179,21,26,4265200,230,110,120
180,21,26,4265300,1484,739,745
181,21,26,4265400,0,0,0
182,21,26,4265500,651,325,326
183,21,26,4265600,566,264,302
184,21,26,4265700,680,331,349
185,21,26,4265800,409,197,212
186,21,26,4265900,741,376,365
187,21,26,4266000,3348,1637,1711
188,21,26,4266100,956,485,471
189,21,26,4266200,678,335,343
190,21,26,4266300,743,384,359
191,21,26,4266400,1138,557,581
192,21,26,4266500,570,279,291
193,21,26,4266600,2065,1050,1015
194,21,26,4266700,1085,523,562
195,21,26,4266800,775,381,394
196,21,26,4266900,540,268,272
197,21,26,4267000,155,85,70
198,21,26,4267100,562,286,276
199,21,26,4267200,1624,838,786
200,21,26,4267300,883,433,450
201,21,26,4267400,1282,648,634
202,21,26,4267500,695,324,371
203,21,26,4267600,611,305,306
204,21,26,4267700,1209,591,618
205,21,26,4267800,703,356,347
206,21,26,4267900,1719,858,861
207,21,26,4268000,1481,729,752
208,21,26,4268100,988,466,522
209,21,26,4268200,715,361,354
210,21,26,4268300,893,434,459
211,21,26,4268400,2590,1275,1315
212,21,26,4268500,728,366,362
213,21,26,4268600,1236,591,645
214,21,26,4268700,276,133,143
215,21,26,4268800,2066,1009,1057
216,21,26,4268900,1005,501,504
217,21,26,4269000,219,100,119
218,21,26,4269100,1083,537,546
219,21,26,4269200,1367,665,702
220,21,26,4269300,501,253,248
221,21,26,4269400,1298,611,687
222,21,26,4269500,1637,799,838
223,21,26,4269600,1091,544,547
224,21,26,4269700,306,142,164
225,21,26,4269800,578,290,288
226,21,26,4269900,343,184,159
227,21,26,4270000,410,193,217
228,21,26,4270100,825,409,416
229,21,26,4270200,211,99,112
230,21,26,4270300,2034,1008,1026
231,21,26,4270400,1625,812,813
232,21,26,4270500,419,207,212
233,21,26,4270600,2932,1486,1446
234,21,26,4270700,1799,894,905
235,21,26,4270800,949,462,487
236,21,26,4270900,1582,792,790
237,21,26,4271000,1120,578,542
238,21,26,4271100,2746,1390,1356
239,21,26,4271200,373,190,183
240,21,26,4271300,1210,599,611
241,21,26,4271400,159,85,74
242,21,26,4271500,448,231,217
243,21,26,4271600,419,220,199
244,21,26,4271700,213,119,94
245,21,26,4271800,112,55,57
246,21,26,4271900,432,216,216
247,21,26,4272000,170,75,95
248,21,26,4272100,1995,1050,945
249,21,26,4272200,2709,1335,1374
250,21,26,4272300,1697,859,838
251,21,26,4272400,0,0,0
252,21,26,4272500,1218,597,621
253,21,26,4272600,786,374,412
254,21,26,4272700,180,87,93
255,21,26,4272800,153,72,81
256,21,26,4272900,318,146,172
257,21,26,4273000,430,197,233
258,21,26,4273100,35,18,17
259,21,26,4273200,402,190,212
260,21,26,4273300,370,172,198
261,21,26,4273400,81,37,44
262,21,26,4273500,64,31,33
263,21,26,4273600,1124,549,575
264,21,26,4273700,785,383,402
265,21,26,4273800,201,95,106
266,21,26,4273900,780,393,387
267,21,26,4274000,60,28,32
268,21,26,4274100,1096,517,579
269,21,26,4274200,1764,898,866
270,21,26,4274300,2106,1063,1043
271,21,26,4274400,769,374,395
272,21,26,4274500,1199,609,590
273,21,26,4274600,1610,759,851
274,21,26,4274700,214,98,116
275,21,26,4274800,1257,612,645
276,21,26,4274900,0,0,0
277,21,26,4275000,678,332,346
278,21,26,4275100,630,301,329
279,21,26,4275200,911,446,465
280,21,26,4275300,1268,644,624
281,21,26,4275400,892,445,447
282,21,26,4275500,761,393,368
283,21,26,4275600,0,0,0
284,21,26,4275700,683,350,333
285,21,26,4275800,1072,534,538
286,21,26,4275900,392,207,185
287,21,26,4276000,495,247,248
288,21,26,4276100,271,138,133
289,21,26,4276200,565,271,294
290,21,26,4276300,1582,794,788
291,21,26,4276400,2180,1035,1145
292,21,26,4276500,840,410,430
293,21,26,4276600,1766,896,870
294,21,26,4276700,1305,676,629
295,21,26,4276800,0,0,0
296,21,26,4276900,1980,1010,970
297,21,26,4277000,2087,1036,1051
298,21,26,4277100,1101,524,577
299,21,26,4277200,602,301,301
300,21,26,4277300,1514,743,771
301,21,26,4277400,1710,846,864
302,21,26,4277500,1094,562,532
303,21,26,4277600,1119,539,580
304,21,26,4277700,2107,1073,1034
305,21,26,4277800,1010,498,512
306,21,26,4277900,690,348,342
307,21,26,4278000,837,413,424
308,21,26,4278100,559,281,278
309,21,26,4278200,419,199,220
310,21,26,4278300,21,9,12
311,21,26,4278400,325,153,172
312,21,26,4278500,676,334,342
313,21,26,4278600,2485,1320,1165
314,21,26,4278700,1388,707,681
315,21,26,4278800,763,396,367
316,21,26,4278900,813,409,404
317,21,26,4279000,984,501,483
318,21,26,4279100,834,439,395
319,21,26,4279200,1272,641,631
320,21,26,4279300,1248,625,623
321,21,26,4279400,33,15,18
322,21,26,4279500,399,207,192
323,21,26,4279600,231,110,121
324,21,26,4279700,543,250,293
325,21,26,4279800,974,492,482
326,21,26,4279900,1392,688,704
327,21,26,4280000,0,0,0
328,21,26,4280100,1605,786,819
329,21,26,4280200,707,355,352
330,21,26,4280300,2258,1109,1149
331,21,26,4280400,935,467,468
332,21,26,4280500,946,460,486
333,21,26,4280600,690,336,354
334,21,26,4280700,887,432,455
335,21,26,4280800,461,237,224
336,21,26,4280900,597,296,301
337,21,26,4281000,309,155,154
338,21,26,4281100,72,37,35
339,21,26,4281200,179,83,96
340,21,26,4281300,133,70,63
341,21,26,4281400,330,157,173
342,21,26,4281500,325,194,131
343,21,26,4281600,1843,930,913
344,21,26,4281700,484,252,232
345,21,26,4281800,0,0,0
346,21,26,4281900,737,380,357
347,21,26,4282000,64,33,31
348,21,26,4282100,1954,956,998
349,21,26,4282200,131,77,54
350,21,26,4282300,351,173,178
351,21,26,4282400,1497,728,769
352,21,26,4282500,1246,626,620
353,21,26,4282600,1176,576,600
354,21,26,4282700,1844,928,916
355,21,26,4282800,684,327,357
356,21,26,4282900,825,421,404
357,21,26,4283000,762,368,394
358,21,26,4283100,767,364,403
359,21,26,4283200,673,327,346
360,21,26,4283300,413,198,215
361,21,26,4283400,270,134,136
362,21,26,4283500,1230,619,611
363,21,26,4283600,673,351,322
364,21,26,4283700,33,20,13
365,21,26,4283800,634,311,323
366,21,26,4283900,249,129,120
367,21,26,4284000,702,340,362
368,21,26,4284100,499,263,236
369,21,26,4284200,277,127,150
370,21,26,4284300,778,399,379
371,21,26,4284400,600,311,289
372,21,26,4284500,841,408,433
373,21,26,4284600,2879,1435,1444
374,21,26,4284700,965,474,491
375,21,26,4284800,227,116,111
376,21,26,4284900,628,331,297
377,21,26,4285000,246,116,130
378,21,26,4285100,537,288,249
379,21,26,4285200,0,0,0
380,21,26,4285300,0,0,0
381,21,26,4285400,275,138,137
382,21,26,4285500,603,302,301
383,21,26,4285600,438,213,225
384,21,26,4285700,323,148,175
385,21,26,4285800,628,325,303
386,21,26,4285900,0,0,0
387,21,26,4286000,415,193,222
388,21,26,4286100,851,409,442
389,21,26,4286200,477,240,237
390,21,26,4286300,341,155,186
391,21,26,4286400,410,199,211
392,21,26,4286500,149,81,68
393,21,26,4286600,57,31,26
394,21,26,4286700,531,255,276
395,21,26,4286800,151,75,76
396,21,26,4286900,74,36,38
397,21,26,4287000,54,27,27
398,21,26,4287100,126,60,66
399,21,26,4287200,120,51,69
400,21,26,4287300,53,20,33
401,21,26,4287400,33,21,12
402,21,26,4287500,12,7,5
403,21,26,4287600,0,0,0
404,21,26,4287700,89,43,46
405,21,26,4287800,171,93,78
406,21,26,4287900,125,62,63
407,21,26,4288000,0,0,0
408,21,26,4288100,129,57,72
409,21,26,4288200,133,59,74
410,21,26,4288300,262,127,135
411,21,26,4288400,118,55,63
412,21,26,4288500,161,72,89
413,21,26,4288600,138,70,68
414,21,26,4288700,0,0,0
415,21,26,4288800,488,265,223
416,21,26,4288900,0,0,0
417,21,26,4289000,0,0,0
418,21,26,4289100,265,135,130
419,21,26,4289200,136,72,64
420,21,26,4289300,99,54,45
421,21,26,4289400,835,409,426
422,21,26,4289500,506,239,267
423,21,26,4289600,532,272,260
424,21,26,4289700,327,153,174
425,21,26,4289800,2762,1415,1347
426,21,26,4289900,873,433,440
427,21,26,4290000,409,208,201
428,21,26,4290100,2963,1564,1399
429,21,26,4290200,1116,562,554
430,21,26,4290300,650,329,321
431,21,26,4290400,841,406,435
432,21,26,4290500,208,106,102
433,21,26,4290600,1023,488,535
434,21,26,4290700,1233,634,599
435,21,26,4290800,604,302,302
436,21,26,4290900,775,394,381
437,21,26,4291000,306,153,153
438,21,26,4291100,655,336,319
439,21,26,4291200,963,475,488
440,21,26,4291300,665,340,325
441,21,26,4291400,952,491,461
442,21,26,4291500,805,403,402
443,21,26,4291600,327,160,167
444,21,26,4291700,661,305,356
445,21,26,4291800,955,478,477
446,21,26,4291900,749,374,375
447,21,26,4292000,172,70,102
448,21,26,4292100,748,377,371
449,21,26,4292200,903,458,445
450,21,26,4292300,310,158,152
451,21,26,4292400,115,53,62
452,21,26,4292500,870,439,431
453,21,26,4292600,69,31,38
454,21,26,4292700,83,42,41
455,21,26,4292800,211,102,109
456,21,26,4292900,791,399,392
457,21,26,4293000,559,278,281
458,21,26,4293100,396,198,198
459,21,26,4293200,759,390,369
460,21,26,4293300,491,242,249
461,21,26,4293400,152,77,75
462,21,26,4293500,439,208,231
463,21,26,4293600,355,187,168
464,21,26,4293700,857,434,423
465,21,26,4293800,0,0,0
466,21,26,4293900,492,245,247
467,21,26,4294000,740,386,354
468,21,26,4294100,0,0,0
469,21,26,4294200,141,69,72
470,21,26,4294300,9,4,5
471,21,26,4294400,0,0,0
472,21,26,4294500,243,115,128
473,21,26,4294600,90,48,42
474,21,26,4294700,115,50,65
475,21,26,4294800,113,54,59
476,21,26,4294900,178,86,92
477,21,26,4295000,89,43,46
478,21,26,4295100,149,82,67
479,21,26,4295200,70,34,36
480,21,26,4295300,185,94,91
481,21,26,4295400,27,10,17
482,21,26,4295500,18,9,9
483,21,26,4295600,20,12,8
484,21,26,4295700,62,30,32
485,21,26,4295800,217,110,107
486,21,26,4295900,0,0,0
487,21,26,4296000,98,54,44
488,21,26,4296100,31,15,16
489,21,26,4296200,0,0,0
490,21,26,4296300,53,24,29
491,21,26,4296400,28,14,14
492,21,26,4296500,167,86,81
493,21,26,4296600,80,38,42
494,21,26,4296700,36,14,22
495,21,26,4296800,172,85,87
496,21,26,4296900,47,23,24
497,21,26,4297000,203,93,110
498,21,26,4297100,96,42,54
499,21,26,4297200,394,185,209
500,21,26,4297300,400,197,203
501,21,26,4297400,0,0,0
502,21,26,4297500,206,96,110
503,21,26,4297600,0,0,0
504,21,26,4297700,62,37,25
505,21,26,4297800,63,33,30
506,21,26,4297900,7,3,4
507,21,26,4298000,81,37,44
508,21,26,4298100,50,28,22
509,21,26,4298200,167,81,86
510,21,26,4298300,56,29,27
511,21,26,4298400,0,0,0
512,21,26,4298500,0,0,0
513,21,26,4298600,76,38,38
514,21,26,4298700,87,47,40
515,21,26,4298800,101,54,47
516,21,26,4298900,179,82,97
517,21,26,4299000,259,128,131
518,21,26,4299100,105,48,57
519,21,26,4299200,0,0,0
520,21,26,4299300,263,139,124
521,21,26,4299400,4,1,3
522,21,26,4299500,69,33,36
523,21,26,4299600,588,296,292
524,21,26,4299700,852,445,407
525,21,26,4299800,181,86,95
526,21,26,4299900,285,160,125
527,21,26,4300000,648,343,305
528,21,26,4300100,407,211,196
529,21,26,4300200,159,86,73
530,21,26,4300300,540,263,277
531,21,26,4300400,271,131,140
532,21,26,4300500,511,258,253
533,21,26,4300600,282,126,156
534,21,26,4300700,256,120,136
535,21,26,4300800,41,17,24
536,21,26,4300900,55,24,31
537,21,26,4301000,524,251,273
538,21,26,4301100,133,72,61
539,21,26,4301200,309,145,164
540,21,26,4301300,553,282,271
541,21,26,4301400,263,134,129
542,21,26,4301500,690,336,354
543,21,26,4301600,275,123,152
544,21,26,4301700,181,89,92
545,21,26,4301800,175,100,75
546,21,26,4301900,736,362,374
547,21,26,4302000,110,51,59
548,21,26,4302100,44,18,26
549,21,26,4302200,86,43,43
550,21,26,4302300,0,0,0
551,21,26,4302400,75,43,32
552,21,26,4302500,51,25,26
553,21,26,4302600,62,30,32
554,21,26,4302700,72,33,39
555,21,26,4302800,53,30,23
556,21,26,4302900,263,132,131
557,21,26,4303000,289,146,143
558,21,26,4303100,14,8,6
559,21,26,4303200,183,81,102
560,21,26,4303300,136,68,68
561,21,26,4303400,0,0,0
562,21,26,4303500,206,100,106
563,21,26,4303600,237,126,111
564,21,26,4303700,72,38,34
565,21,26,4303800,0,0,0
566,21,26,4303900,250,129,121
567,21,26,4304000,16,10,6
568,21,26,4304100,205,102,103
569,21,26,4304200,397,186,211
570,21,26,4304300,589,295,294
571,21,26,4304400,210,100,110
572,21,26,4304500,207,102,105
573,21,26,4304600,331,158,173
574,21,26,4304700,524,250,274
575,21,26,4304800,1085,528,557
576,21,26,4304900,69,37,32
577,21,26,4305000,24,17,7
578,21,26,4305100,72,42,30
579,21,26,4305200,142,68,74
580,21,26,4305300,107,48,59
581,21,26,4305400,5,3,2
582,21,26,4305500,447,212,235
583,21,26,4305600,99,44,55
584,21,26,4305700,92,46,46
585,21,26,4305800,77,36,41
586,21,26,4305900,153,74,79
587,21,26,4306000,465,225,240
588,21,26,4306100,125,59,66
589,21,26,4306200,74,37,37
590,21,26,4306300,23,15,8
591,21,26,4306400,42,18,24
592,21,26,4306500,105,56,49
593,21,26,4306600,121,64,57
594,21,26,4306700,101,50,51
595,21,26,4306800,57,28,29
596,21,26,4306900,42,23,19
597,21,26,4307000,206,90,116
598,21,26,4307100,357,185,172
599,21,26,4307200,0,0,0
600,21,26,4307300,144,66,78
601,21,26,4307400,121,61,60
602,21,26,4307500,106,55,51
603,21,26,4307600,310,158,152
604,21,26,4307700,103,42,61
605,21,26,4307800,139,59,80
606,21,26,4307900,0,0,0
607,21,26,4308000,61,31,30
608,21,26,4308100,53,24,29
609,21,26,4308200,48,22,26
610,21,26,4308300,299,147,152
611,21,26,4308400,27,14,13
612,21,26,4308500,38,15,23
613,21,26,4308600,211,110,101
614,21,26,4308700,229,107,122
615,21,26,4308800,0,0,0
616,21,26,4308900,1134,551,583
617,21,26,4309000,683,342,341
618,21,26,4309100,1998,1010,988
619,21,26,4309200,2163,1076,1087
620,21,26,4309300,1746,900,846
621,21,26,4309400,763,386,377
622,21,26,4309500,597,305,292
623,21,26,4309600,256,131,125
624,21,26,4309700,340,180,160
625,21,26,4309800,1647,870,777
626,21,26,4309900,354,187,167
627,21,26,4310000,660,325,335
628,21,26,4310100,2362,1194,1168
629,21,26,4310200,401,211,190
630,21,26,4310300,350,164,186
631,21,26,4310400,394,200,194
632,21,26,4310500,760,380,380
633,21,26,4310600,368,187,181
634,21,26,4310700,1714,837,877
635,21,26,4310800,1546,747,799
636,21,26,4310900,765,376,389
637,21,26,4311000,801,413,388
638,21,26,4311100,576,301,275
639,21,26,4311200,543,289,254
640,21,26,4311300,408,200,208
641,21,26,4311400,668,336,332
642,21,26,4311500,1343,678,665
643,21,26,4311600,288,140,148
644,21,26,4311700,296,154,142
645,21,26,4311800,1556,774,782
646,21,26,4311900,1882,917,965
647,21,26,4312000,714,348,366
648,21,26,4312100,713,358,355
649,21,26,4312200,2741,1375,1366
650,21,26,4312300,0,0,0
651,21,26,4312400,1986,1007,979
652,21,26,4312500,765,388,377
653,21,26,4312600,0,0,0
654,21,26,4312700,905,454,451
655,21,26,4312800,657,325,332
656,21,26,4312900,0,0,0
657,21,26,4313000,565,276,289
658,21,26,4313100,83,40,43
659,21,26,4313200,232,115,117
660,21,26,4313300,363,181,182
661,21,26,4313400,192,90,102
662,21,26,4313500,449,221,228
663,21,26,4313600,537,259,278
664,21,26,4313700,1843,915,928
665,21,26,4313800,257,127,130
666,21,26,4313900,815,409,406
667,21,26,4314000,527,260,267
668,21,26,4314100,749,366,383
669,21,26,4314200,794,388,406
670,21,26,4314300,172,83,89
671,21,26,4314400,1126,586,540
672,21,26,4314500,1044,520,524
673,21,26,4314600,1462,732,730
674,21,26,4314700,765,363,402
675,21,26,4314800,1942,1001,941
676,21,26,4314900,678,342,336
677,21,26,4315000,1129,565,564
678,21,26,4315100,1304,687,617
679,21,26,4315200,670,331,339
680,21,26,4315300,0,0,0
681,21,26,4315400,3382,1697,1685
682,21,26,4315500,1173,592,581
683,21,26,4315600,0,0,0
684,21,26,4315700,2143,1042,1101
685,21,26,4315800,622,302,320
686,21,26,4315900,1895,930,965
687,21,26,4316000,2252,1148,1104
688,21,26,4316100,1109,567,542
689,21,26,4316200,80,41,39
690,21,26,4316300,2011,983,1028
691,21,26,4316400,253,116,137
692,21,26,4316500,883,434,449
693,21,26,4316600,390,199,191
694,21,26,4316700,468,240,228
695,21,26,4316800,474,225,249
696,21,26,4316900,468,239,229
697,21,26,4317000,1741,872,869
698,21,26,4317100,1219,617,602
699,21,26,4317200,2716,1400,1316
700,21,26,4317300,1229,596,633
701,21,26,4317400,1009,532,477
702,21,26,4317500,884,429,455
703,21,26,4317600,0,0,0
704,21,26,4317700,427,212,215
705,21,26,4317800,1739,886,853
706,21,26,4317900,1331,693,638
707,21,26,4318000,486,244,242
708,21,26,4318100,828,403,425
709,21,26,4318200,1005,479,526
710,21,26,4318300,1321,675,646
711,21,26,4318400,565,277,288
712,21,26,4318500,1340,689,651
713,21,26,4318600,582,291,291
714,21,26,4318700,482,238,244
715,21,26,4318800,1521,750,771
716,21,26,4318900,1707,835,872
717,21,26,4319000,639,345,294
718,21,26,4319100,657,330,327
719,21,26,4319200,598,295,303
720,21,26,4319300,1242,603,639
721,21,26,4319400,1521,753,768
722,21,26,4319500,0,0,0
723,21,26,4319600,344,170,174
724,21,26,4319700,673,338,335
725,21,26,4319800,2109,1055,1054
726,21,26,4319900,380,193,187
727,21,26,4320000,856,416,440
728,21,26,4320100,1298,623,675
729,21,26,4320200,0,0,0
730,21,26,4320300,1081,551,530
731,21,26,4320400,1530,740,790
732,21,26,4320500,204,88,116
733,21,26,4320600,1142,586,556
734,21,26,4320700,4077,2065,2012
735,21,26,4320800,681,337,344
736,21,26,4320900,1947,938,1009
737,21,26,4321000,0,0,0
738,21,26,4321100,618,283,335
739,21,26,4321200,1395,706,689
740,21,26,4321300,1109,570,539
741,21,26,4321400,1910,932,978
742,21,26,4321500,982,472,510
743,21,26,4321600,466,230,236
744,21,26,4321700,390,208,182
745,21,26,4321800,1537,791,746
746,21,26,4321900,479,244,235
747,21,26,4322000,449,237,212
748,21,26,4322100,439,221,218
749,21,26,4322200,671,338,333
750,21,26,4322300,5,2,3
751,21,26,4322400,802,389,413
752,21,26,4322500,1527,779,748
753,21,26,4322600,1301,650,651
754,21,26,4322700,785,387,398
755,21,26,4322800,1139,569,570
756,21,26,4322900,1325,643,682
757,21,26,4323000,603,311,292
758,21,26,4323100,805,396,409
759,21,26,4323200,1009,491,518
760,21,26,4323300,1873,915,958
761,21,26,4323400,3015,1564,1451
762,21,26,4323500,0,0,0
763,21,26,4323600,2387,1207,1180
764,21,26,4323700,605,299,306
765,21,26,4323800,805,399,406
766,21,26,4323900,72,43,29
767,21,26,4324000,1000,493,507
768,21,26,4324100,1543,776,767
769,21,26,4324200,0,0,0
770,21,26,4324300,1016,513,503
771,21,26,4324400,644,332,312
772,21,26,4324500,0,0,0
773,21,26,4324600,1536,750,786
774,21,26,4324700,340,171,169
775,21,26,4324800,2380,1217,1163
776,21,26,4324900,1060,532,528
777,21,26,4325000,778,368,410
778,21,26,4325100,602,288,314
779,21,26,4325200,2185,1083,1102
780,21,26,4325300,316,160,156
781,21,26,4325400,728,357,371
782,21,26,4325500,1886,929,957
783,21,26,4325600,615,295,320
784,21,26,4325700,286,142,144
785,21,26,4325800,1033,521,512
786,21,26,4325900,844,452,392
787,21,26,4326000,367,191,176
788,21,26,4326100,828,422,406
789,21,26,4326200,335,158,177
790,21,26,4326300,1086,549,537
791,21,26,4326400,299,152,147
792,21,26,4326500,1630,796,834
793,21,26,4326600,1477,768,709
794,21,26,4326700,427,216,211
795,21,26,4326800,759,369,390
796,21,26,4326900,221,113,108
797,21,26,4327000,929,475,454
798,21,26,4327100,1382,697,685
799,21,26,4327200,1379,715,664
800,21,26,4327300,1584,813,771
801,21,26,4327400,3334,1679,1655
802,21,26,4327500,647,324,323
803,21,26,4327600,73,36,37
804,21,26,4327700,780,399,381
805,21,26,4327800,1028,523,505
806,21,26,4327900,426,221,205
807,21,26,4328000,0,0,0
808,21,26,4328100,460,230,230
809,21,26,4328200,327,165,162
810,21,26,4328300,631,312,319
811,21,26,4328400,237,108,129
812,21,26,4328500,252,127,125
813,21,26,4328600,219,101,118
814,21,26,4328700,546,269,277
815,21,26,4328800,613,306,307
816,21,26,4328900,114,54,60
817,21,26,4329000,356,177,179
818,21,26,4329100,162,74,88
819,21,26,4329200,35,20,15
820,21,26,4329300,318,174,144
821,21,26,4329400,259,129,130
822,21,26,4329500,252,129,123
823,21,26,4329600,59,27,32
824,21,26,4329700,67,31,36
825,21,26,4329800,9,3,6
826,21,26,4329900,850,473,377
827,21,26,4330000,407,207,200
828,21,26,4330100,469,220,249
829,21,26,4330200,247,120,127
830,21,26,4330300,747,361,386
831,21,26,4330400,217,101,116
832,21,26,4330500,146,73,73
833,21,26,4330600,28,20,8
834,21,26,4330700,142,64,78
835,21,26,4330800,94,51,43
836,21,26,4330900,349,178,171
837,21,26,4331000,997,563,434
838,21,26,4331100,1272,649,623
839,21,26,4331200,676,328,348
840,21,26,4331300,1579,831,748
841,21,26,4331400,174,86,88
842,21,26,4331500,2060,1027,1033
843,21,26,4331600,363,181,182
844,21,26,4331700,243,114,129
845,21,26,4331800,192,83,109
846,21,26,4331900,305,153,152
847,21,26,4332000,985,504,481
848,21,26,4332100,689,327,362
849,21,26,4332200,408,223,185
850,21,26,4332300,46,21,25
851,21,26,4332400,697,351,346
852,21,26,4332500,138,76,62
853,21,26,4332600,327,154,173
854,21,26,4332700,1402,674,728
855,21,26,4332800,0,0,0
856,21,26,4332900,498,230,268
857,21,26,4333000,288,151,137
858,21,26,4333100,796,404,392
859,21,26,4333200,661,323,338
860,21,26,4333300,773,379,394
861,21,26,4333400,366,178,188
862,21,26,4333500,147,74,73
863,21,26,4333600,493,224,269
864,21,26,4333700,296,131,165
865,21,26,4333800,491,238,253
866,21,26,4333900,492,256,236
867,21,26,4334000,1810,857,953
868,21,26,4334100,602,290,312
869,21,26,4334200,177,88,89
870,21,26,4334300,530,269,261
871,21,26,4334400,175,82,93
872,21,26,4334500,295,153,142
873,21,26,4334600,270,142,128
874,21,26,4334700,246,116,130
875,21,26,4334800,434,212,222
876,21,26,4334900,544,260,284
877,21,26,4335000,1205,528,677
878,21,26,4335100,294,153,141
879,21,26,4335200,786,400,386
880,21,26,4335300,830,452,378
881,21,26,4335400,512,247,265
882,21,26,4335500,603,284,319
883,21,26,4335600,253,127,126
884,21,26,4335700,219,107,112
885,21,26,4335800,203,105,98
886,21,26,4335900,0,0,0
887,21,26,4336000,183,98,85
888,21,26,4336100,0,0,0
889,21,26,4336200,882,441,441
890,21,26,4336300,0,0,0
891,21,26,4336400,74,38,36
892,21,26,4336500,380,184,196
893,21,26,4336600,106,57,49
894,21,26,4336700,134,67,67
895,21,26,4336800,79,46,33
896,21,26,4336900,88,36,52
897,21,26,4337000,157,79,78
898,21,26,4337100,493,227,266
899,21,26,4337200,50,23,27
900,21,26,4337300,238,119,119
901,21,26,4337400,171,82,89
902,21,26,4337500,167,73,94
903,21,26,4337600,38,20,18
904,21,26,4337700,219,99,120
905,21,26,4337800,40,21,19
906,21,26,4337900,171,72,99
907,21,26,4338000,233,107,126
908,21,26,4338100,549,257,292
909,21,26,4338200,136,70,66
910,21,26,4338300,125,64,61
911,21,26,4338400,239,128,111
912,21,26,4338500,545,266,279
913,21,26,4338600,597,286,311
914,21,26,4338700,335,177,158
915,21,26,4338800,159,87,72
916,21,26,4338900,243,131,112
917,21,26,4339000,166,85,81
918,21,26,4339100,56,27,29
919,21,26,4339200,308,157,151
920,21,26,4339300,625,312,313
921,21,26,4339400,229,113,116
922,21,26,4339500,303,149,154
923,21,26,4339600,166,92,74
924,21,26,4339700,142,79,63
925,21,26,4339800,368,190,178
926,21,26,4339900,704,357,347
927,21,26,4340000,118,54,64
928,21,26,4340100,75,46,29
929,21,26,4340200,1484,752,732
930,21,26,4340300,474,234,240
931,21,26,4340400,10,5,5
932,21,26,4340500,259,126,133
933,21,26,4340600,227,115,112
934,21,26,4340700,51,28,23
935,21,26,4340800,72,41,31
936,21,26,4340900,103,53,50
937,21,26,4341000,88,46,42
938,21,26,4341100,24,10,14
939,21,26,4341200,23,12,11
940,21,26,4341300,17,7,10
941,21,26,4341400,24,11,13
942,21,26,4341500,107,49,58
943,21,26,4341600,141,64,77
944,21,26,4341700,299,152,147
945,21,26,4341800,90,42,48
946,21,26,4341900,161,80,81
947,21,26,4342000,125,62,63
948,21,26,4342100,49,25,24
949,21,26,4342200,134,64,70
950,21,26,4342300,87,41,46
951,21,26,4342400,107,46,61
952,21,26,4342500,82,41,41
953,21,26,4342600,68,31,37
954,21,26,4342700,475,245,230
955,21,26,4342800,434,210,224
956,21,26,4342900,819,410,409
957,21,26,4343000,2092,1063,1029
958,21,26,4343100,198,100,98
959,21,26,4343200,723,358,365
960,21,26,4343300,1201,589,612
961,21,26,4343400,575,286,289
962,21,26,4343500,295,142,153
963,21,26,4343600,258,126,132
964,21,26,4343700,879,414,465
965,21,26,4343800,297,147,150
966,21,26,4343900,131,62,69
967,21,26,4344000,377,181,196
968,21,26,4344100,139,69,70
969,21,26,4344200,638,303,335
970,21,26,4344300,273,142,131
971,21,26,4344400,612,321,291
972,21,26,4344500,276,140,136
973,21,26,4344600,1350,674,676
974,21,26,4344700,1257,661,596
975,21,26,4344800,976,518,458
976,21,26,4344900,1995,1048,947
977,21,26,4345000,3178,1566,1612
978,21,26,4345100,814,406,408
979,21,26,4345200,1011,519,492
980,21,26,4345300,1049,514,535
981,21,26,4345400,584,305,279
982,21,26,4345500,998,474,524
983,21,26,4345600,1268,636,632
984,21,26,4345700,461,220,241
985,21,26,4345800,183,90,93
986,21,26,4345900,1669,840,829
987,21,26,4346000,266,145,121
988,21,26,4346100,199,96,103
989,21,26,4346200,409,203,206
990,21,26,4346300,164,90,74
991,21,26,4346400,258,127,131
992,21,26,4346500,151,67,84
993,21,26,4346600,80,33,47
994,21,26,4346700,272,132,140
995,21,26,4346800,588,295,293
996,21,26,4346900,353,185,168
997,21,26,4347000,380,185,195
998,21,26,4347100,324,162,162
999,21,26,4347200,282,132,150
1000,21,26,4347300,275,138,137
1001,21,26,4347400,108,53,55
1002,21,26,4347500,612,291,321
1003,21,26,4347600,428,210,218
1004,21,26,4347700,434,214,220
1005,21,26,4347800,292,155,137
1006,21,26,4347900,461,225,236
1007,21,26,4348000,1112,578,534
1008,21,26,4348100,932,467,465
1009,21,26,4348200,2055,1044,1011
1010,21,26,4348300,2503,1272,1231
1011,21,26,4348400,1485,776,709
1012,21,26,4348500,2071,1042,1029
1013,21,26,4348600,961,477,484
1014,21,26,4348700,499,251,248
1015,21,26,4348800,1302,662,640
1016,21,26,4348900,628,291,337
1017,21,26,4349000,865,438,427
1018,21,26,4349100,1013,506,507
1019,21,26,4349200,596,295,301
1020,21,26,4349300,740,369,371
1021,21,26,4349400,268,136,132
1022,21,26,4349500,1795,869,926
1023,21,26,4349600,593,279,314
1024,21,26,4349700,775,382,393
1025,21,26,4349800,81,40,41
1026,21,26,4349900,109,49,60
1027,21,26,4350000,203,108,95
1028,21,26,4350100,1962,961,1001
1029,21,26,4350200,192,142,50
1030,21,26,4350300,0,0,0
1031,21,26,4350400,160,80,80
1032,21,26,4350500,0,0,0
1033,21,26,4350600,968,474,494
1034,21,26,4350700,122,64,58
1035,21,26,4350800,0,0,0
1036,21,26,4350900,121,60,61
1037,21,26,4351000,127,60,67
1038,21,26,4351100,112,55,57
1039,21,26,4351200,146,68,78
1040,21,26,4351300,129,68,61
1041,21,26,4351400,190,88,102
1042,21,26,4351500,16,8,8
1043,21,26,4351600,149,82,67
1044,21,26,4351700,69,34,35
1045,21,26,4351800,0,0,0
1046,21,26,4351900,94,47,47
1047,21,26,4352000,366,183,183
1048,21,26,4352100,0,0,0
1049,21,26,4352200,238,110,128
1050,21,26,4352300,226,96,130
1051,21,26,4352400,90,41,49
1052,21,26,4352500,67,35,32
1053,21,26,4352600,0,0,0
1054,21,26,4352700,417,198,219
1055,21,26,4352800,482,242,240
1056,21,26,4352900,37,17,20
1057,21,26,4353000,455,225,230
1058,21,26,4353100,149,72,77
1059,21,26,4353200,0,0,0
1060,21,26,4353300,162,81,81
1061,21,26,4353400,211,103,108
1062,21,26,4353500,520,239,281
1063,21,26,4353600,935,458,477
1064,21,26,4353700,638,312,326
1065,21,26,4353800,508,259,249
1066,21,26,4353900,251,119,132
1067,21,26,4354000,146,67,79
1068,21,26,4354100,695,355,340
1069,21,26,4354200,629,303,326
1070,21,26,4354300,236,116,120
1071,21,26,4354400,256,116,140
1072,21,26,4354500,1517,762,755
1073,21,26,4354600,0,0,0
1074,21,26,4354700,1165,567,598
1075,21,26,4354800,511,297,214
1076,21,26,4354900,54,29,25
1077,21,26,4355000,18,10,8
1078,21,26,4355100,0,0,0
1079,21,26,4355200,105,44,61
1080,21,26,4355300,157,70,87
1081,21,26,4355400,133,59,74
1082,21,26,4355500,128,60,68
1083,21,26,4355600,63,35,28
1084,21,26,4355700,114,56,58
1085,21,26,4355800,67,36,31
1086,21,26,4355900,237,120,117
1087,21,26,4356000,0,0,0
1088,21,26,4356100,38,15,23
1089,21,26,4356200,15,9,6
1090,21,26,4356300,85,42,43
1091,21,26,4356400,141,73,68
1092,21,26,4356500,4,2,2
1093,21,26,4356600,51,23,28
1094,21,26,4356700,40,17,23
1095,21,26,4356800,121,56,65
1096,21,26,4356900,82,35,47
1097,21,26,4357000,43,22,21
1098,21,26,4357100,20,9,11
1099,21,26,4357200,170,74,96
1100,21,26,4357300,60,27,33
1101,21,26,4357400,81,44,37
1102,21,26,4357500,305,142,163
1103,21,26,4357600,50,22,28
1104,21,26,4357700,42,20,22
1105,21,26,4357800,25,11,14
1106,21,26,4357900,148,63,85
1107,21,26,4358000,159,79,80
1108,21,26,4358100,63,29,34
1109,21,26,4358200,0,0,0
1110,21,26,4358300,21,10,11
1111,21,26,4358400,0,0,0
1112,21,26,4358500,62,28,34
1113,21,26,4358600,54,29,25
1114,21,26,4358700,23,12,11
1115,21,26,4358800,0,0,0
1116,21,26,4358900,477,242,235
1117,21,26,4359000,123,59,64
1118,21,26,4359100,0,0,0
1119,21,26,4359200,174,85,89
1120,21,26,4359300,89,43,46
1121,21,26,4359400,129,68,61
1122,21,26,4359500,24,12,12
1123,21,26,4359600,122,59,63
1124,21,26,4359700,72,31,41
1125,21,26,4359800,53,23,30
1126,21,26,4359900,242,123,119
1127,21,26,4360000,164,82,82
1128,21,26,4360100,232,126,106
1129,21,26,4360200,57,27,30
1130,21,26,4360300,14,7,7
1131,21,26,4360400,86,37,49
1132,21,26,4360500,82,37,45
1133,21,26,4360600,54,28,26
1134,21,26,4360700,80,41,39
1135,21,26,4360800,417,207,210
1136,21,26,4360900,430,204,226
1137,21,26,4361000,95,53,42
1138,21,26,4361100,727,369,358
1139,21,26,4361200,306,153,153
1140,21,26,4361300,107,48,59
1141,21,26,4361400,270,134,136
1142,21,26,4361500,20,11,9
1143,21,26,4361600,345,166,179
1144,21,26,4361700,384,183,201
1145,21,26,4361800,23,11,12
1146,21,26,4361900,152,81,71
1147,21,26,4362000,0,0,0
1148,21,26,4362100,0,0,0
1149,21,26,4362200,788,410,378
1150,21,26,4362300,394,187,207
1151,21,26,4362400,822,423,399
1152,21,26,4362500,1414,696,718
1153,21,26,4362600,1787,892,895
1154,21,26,4362700,499,243,256
1155,21,26,4362800,340,159,181
1156,21,26,4362900,454,223,231
1157,21,26,4363000,563,286,277
1158,21,26,4363100,382,214,168
1159,21,26,4363200,355,185,170
1160,21,26,4363300,1132,543,589
1161,21,26,4363400,1364,701,663
1162,21,26,4363500,2104,1076,1028
1163,21,26,4363600,107,50,57
1164,21,26,4363700,546,256,290
1165,21,26,4363800,1112,543,569
1166,21,26,4363900,417,201,216
1167,21,26,4364000,501,230,271
1168,21,26,4364100,292,148,144
1169,21,26,4364200,133,70,63
1170,21,26,4364300,197,98,99
1171,21,26,4364400,109,60,49
1172,21,26,4364500,407,201,206
1173,21,26,4364600,151,79,72
1174,21,26,4364700,152,80,72
1175,21,26,4364800,0,0,0
1176,21,26,4364900,25,11,14
1177,21,26,4365000,59,28,31
1178,21,26,4365100,224,113,111
1179,21,26,4365200,294,155,139
1180,21,26,4365300,233,113,120
1181,21,26,4365400,244,120,124
1182,21,26,4365500,373,188,185
1183,21,26,4365600,17,10,7
1184,21,26,4365700,436,239,197
1185,21,26,4365800,379,191,188
1186,21,26,4365900,136,76,60
1187,21,26,4366000,141,80,61
1188,21,26,4366100,948,471,477
1189,21,26,4366200,399,205,194
1190,21,26,4366300,268,131,137
1191,21,26,4366400,1559,787,772
1192,21,26,4366500,139,74,65
1193,21,26,4366600,412,208,204
1194,21,26,4366700,1108,540,568
1195,21,26,4366800,915,442,473
1196,21,26,4366900,1186,573,613
1197,21,26,4367000,2310,1128,1182
1198,21,26,4367100,690,340,350
1199,21,26,4367200,684,341,343
1200,21,26,4367300,224,114,110
1201,21,26,4367400,899,440,459
1202,21,26,4367500,1253,645,608
1203,21,26,4367600,1534,788,746
1204,21,26,4367700,1531,774,757
1205,21,26,4367800,575,278,297
1206,21,26,4367900,567,290,277
1207,21,26,4368000,730,374,356
1208,21,26,4368100,361,173,188
1209,21,26,4368200,229,120,109
1210,21,26,4368300,159,81,78
1211,21,26,4368400,429,205,224
1212,21,26,4368500,505,250,255
1213,21,26,4368600,884,416,468
1214,21,26,4368700,1362,698,664
1215,21,26,4368800,8156,4245,3911
1216,21,26,4368900,638,325,313
1217,21,26,4369000,181,92,89
1218,21,26,4369100,606,308,298
1219,21,26,4369200,388,173,215
1220,21,26,4369300,0,0,0
1221,21,26,4369400,423,200,223
1222,21,26,4369500,62,35,27
1223,21,26,4369600,260,128,132
1224,21,26,4369700,152,81,71
1225,21,26,4369800,623,315,308
1226,21,26,4369900,357,178,179
1227,21,26,4370000,276,129,147
1228,21,26,4370100,314,148,166
1229,21,26,4370200,210,106,104
1230,21,26,4370300,127,70,57
1231,21,26,4370400,138,70,68
1232,21,26,4370500,35,18,17
1233,21,26,4370600,0,0,0
1234,21,26,4370700,48,20,28
1235,21,26,4370800,126,66,60
1236,21,26,4370900,83,41,42
1237,21,26,4371000,75,37,38
1238,21,26,4371100,96,51,45
1239,21,26,4371200,136,68,68
1240,21,26,4371300,260,120,140
1241,21,26,4371400,40,22,18
1242,21,26,4371500,380,185,195
1243,21,26,4371600,35,17,18
1244,21,26,4371700,31,20,11
1245,21,26,4371800,469,232,237
1246,21,26,4371900,48,25,23
1247,21,26,4372000,24,11,13
1248,21,26,4372100,213,109,104
1249,21,26,4372200,102,61,41
1250,21,26,4372300,175,83,92
1251,21,26,4372400,115,66,49
1252,21,26,4372500,258,126,132
1253,21,26,4372600,0,0,0
1254,21,26,4372700,252,120,132
1255,21,26,4372800,401,193,208
1256,21,26,4372900,1043,610,433
1257,21,26,4373000,394,181,213
1258,21,26,4373100,283,160,123
1259,21,26,4373200,349,190,159
1260,21,26,4373300,89,55,34
1261,21,26,4373400,0,0,0
1262,21,26,4373500,72,37,35
1263,21,26,4373600,66,28,38
1264,21,26,4373700,114,51,63
1265,21,26,4373800,0,0,0
1266,21,26,4373900,0,0,0
1267,21,26,4374000,72,34,38
1268,21,26,4374100,257,115,142
1269,21,26,4374200,35,18,17
1270,21,26,4374300,77,36,41
1271,21,26,4374400,238,129,109
1272,21,26,4374500,79,38,41
1273,21,26,4374600,120,54,66
1274,21,26,4374700,43,24,19
1275,21,26,4374800,73,33,40
1276,21,26,4374900,0,0,0
1277,21,26,4375000,83,41,42
1278,21,26,4375100,64,35,29
1279,21,26,4375200,8,5,3
1280,21,26,4375300,33,18,15
1281,21,26,4375400,62,28,34
1282,21,26,4375500,0,0,0
1283,21,26,4375600,37,20,17
1284,21,26,4375700,0,0,0
1285,21,26,4375800,179,89,90
1286,21,26,4375900,0,0,0
1287,21,26,4376000,0,0,0
1288,21,26,4376100,38,15,23
1289,21,26,4376200,22,8,14
1290,21,26,4376300,14,8,6
1291,21,26,4376400,167,72,95
1292,21,26,4376500,90,38,52
1293,21,26,4376600,17,9,8
1294,21,26,4376700,16,8,8
1295,21,26,4376800,38,20,18
1296,21,26,4376900,337,177,160
1297,21,26,4377000,713,341,372
1298,21,26,4377100,87,44,43
1299,21,26,4377200,86,40,46
1300,21,26,4377300,272,148,124
1301,21,26,4377400,92,42,50
1302,21,26,4377500,20,10,10
1303,21,26,4377600,92,43,49
1304,21,26,4377700,257,110,147
1305,21,26,4377800,0,0,0
1306,21,26,4377900,435,229,206
1307,21,26,4378000,56,24,32
1308,21,26,4378100,188,86,102
1309,21,26,4378200,118,63,55
1310,21,26,4378300,27,8,19
1311,21,26,4378400,472,231,241
1312,21,26,4378500,0,0,0
1313,21,26,4378600,260,129,131
1314,21,26,4378700,123,64,59
1315,21,26,4378800,66,27,39
1316,21,26,4378900,10,7,3
1317,21,26,4379000,95,36,59
1318,21,26,4379100,29,16,13
1319,21,26,4379200,3080,1591,1489
1320,21,26,4379300,206,103,103
1321,21,26,4379400,249,134,115
1322,21,26,4379500,662,351,311
1323,21,26,4379600,145,70,75
1324,21,26,4379700,257,119,138
1325,21,26,4379800,56,33,23
1326,21,26,4379900,251,132,119
1327,21,26,4380000,61,24,37
1328,21,26,4380100,0,0,0
1329,21,26,4380200,442,208,234
1330,21,26,4380300,362,192,170
1331,21,26,4380400,73,34,39
1332,21,26,4380500,144,67,77
1333,21,26,4380600,165,83,82
1334,21,26,4380700,67,33,34
1335,21,26,4380800,377,185,192
1336,21,26,4380900,38,24,14
1337,21,26,4381000,206,106,100
1338,21,26,4381100,328,162,166
1339,21,26,4381200,75,34,41
1340,21,26,4381300,616,278,338
1341,21,26,4381400,188,87,101
1342,21,26,4381500,322,155,167
1343,21,26,4381600,342,159,183
1344,21,26,4381700,86,35,51
1345,21,26,4381800,231,106,125
1346,21,26,4381900,805,406,399
1347,21,26,4382000,159,69,90
1348,21,26,4382100,0,0,0
1349,21,26,4382200,197,96,101
1350,21,26,4382300,0,0,0
1351,21,26,4382400,374,179,195
1352,21,26,4382500,159,81,78
1353,21,26,4382600,177,83,94
1354,21,26,4382700,70,35,35
1355,21,26,4382800,180,99,81
1356,21,26,4382900,134,61,73
1357,21,26,4383000,170,77,93
1358,21,26,4383100,166,81,85
1359,21,26,4383200,769,393,376
1360,21,26,4383300,593,301,292
1361,21,26,4383400,649,319,330
1362,21,26,4383500,178,87,91
1363,21,26,4383600,77,42,35
1364,21,26,4383700,0,0,0
1365,21,26,4383800,588,283,305
1366,21,26,4383900,485,243,242
1367,21,26,4384000,429,208,221
1368,21,26,4384100,0,0,0
1369,21,26,4384200,93,47,46
1370,21,26,4384300,73,35,38
1371,21,26,4384400,100,49,51
1372,21,26,4384500,90,44,46
1373,21,26,4384600,282,139,143
1374,21,26,4384700,155,73,82
1375,21,26,4384800,151,80,71
1376,21,26,4384900,492,257,235
1377,21,26,4385000,116,56,60
1378,21,26,4385100,183,85,98
1379,21,26,4385200,125,55,70
1380,21,26,4385300,151,72,79
1381,21,26,4385400,207,102,105
1382,21,26,4385500,112,55,57
1383,21,26,4385600,63,28,35
1384,21,26,4385700,86,37,49
1385,21,26,4385800,205,90,115
1386,21,26,4385900,96,46,50
1387,21,26,4386000,154,79,75
1388,21,26,4386100,260,129,131
1389,21,26,4386200,856,407,449
1390,21,26,4386300,232,125,107
1391,21,26,4386400,204,93,111
1392,21,26,4386500,462,216,246
1393,21,26,4386600,101,46,55
1394,21,26,4386700,0,0,0
1395,21,26,4386800,0,0,0
1396,21,26,4386900,312,148,164
1397,21,26,4387000,828,406,422
1398,21,26,4387100,296,140,156
1399,21,26,4387200,57,33,24
1400,21,26,4387300,465,233,232
1401,21,26,4387400,613,303,310
1402,21,26,4387500,30,15,15
1403,21,26,4387600,0,0,0
1404,21,26,4387700,273,131,142
1405,21,26,4387800,0,0,0
1406,21,26,4387900,60,29,31
1407,21,26,4388000,35,15,20
1408,21,26,4388100,98,42,56
1409,21,26,4388200,0,0,0
1410,21,26,4388300,56,28,28
1411,21,26,4388400,128,57,71
1412,21,26,4388500,458,252,206
1413,21,26,4388600,147,76,71
1414,21,26,4388700,62,25,37
1415,21,26,4388800,67,33,34
1416,21,26,4388900,259,132,127
1417,21,26,4389000,92,43,49
1418,21,26,4389100,72,37,35
1419,21,26,4389200,212,96,116
1420,21,26,4389300,325,160,165
1421,21,26,4389400,148,73,75
1422,21,26,4389500,180,86,94
1423,21,26,4389600,239,118,121
1424,21,26,4389700,263,135,128
1425,21,26,4389800,0,0,0
1426,21,26,4389900,857,420,437
1427,21,26,4390000,234,126,108
1428,21,26,4390100,207,96,111
1429,21,26,4390200,325,165,160
1430,21,26,4390300,106,47,59
1431,21,26,4390400,144,76,68
1432,21,26,4390500,99,49,50
1433,21,26,4390600,0,0,0
1434,21,26,4390700,275,144,131
1435,21,26,4390800,34,17,17
1436,21,26,4390900,114,59,55
1437,21,26,4391000,107,50,57
1438,21,26,4391100,0,0,0
1439,21,26,4391200,766,380,386
1440,21,26,4391300,188,99,89
1441,21,26,4391400,158,75,83
1442,21,26,4391500,85,36,49
1443,21,26,4391600,38,21,17
1444,21,26,4391700,170,77,93
1445,21,26,4391800,247,123,124
1446,21,26,4391900,1,0,1
1447,21,26,4392000,3439,1780,1659
1448,21,26,4392100,152,82,70
1449,21,26,4392200,122,63,59
1450,21,26,4392300,38,20,18
1451,21,26,4392400,42,18,24
1452,21,26,4392500,70,28,42
1453,21,26,4392600,183,80,103
1454,21,26,4392700,177,72,105
1455,21,26,4392800,113,61,52
1456,21,26,4392900,406,208,198
1457,21,26,4393000,212,110,102
1458,21,26,4393100,388,200,188
1459,21,26,4393200,428,214,214
1460,21,26,4393300,118,57,61
1461,21,26,4393400,174,80,94
1462,21,26,4393500,136,67,69
1463,21,26,4393600,167,74,93
1464,21,26,4393700,285,135,150
1465,21,26,4393800,57,33,24
1466,21,26,4393900,0,0,0
1467,21,26,4394000,0,0,0
1468,21,26,4394100,238,106,132
1469,21,26,4394200,645,327,318
1470,21,26,4394300,519,257,262
1471,21,26,4394400,186,90,96
1472,21,26,4394500,85,41,44
1473,21,26,4394600,301,151,150
1474,21,26,4394700,383,192,191
1475,21,26,4394800,59,28,31
1476,21,26,4394900,306,141,165
1477,21,26,4395000,42,17,25
1478,21,26,4395100,68,35,33
1479,21,26,4395200,146,67,79
1480,21,26,4395300,540,271,269
1481,21,26,4395400,198,105,93
1482,21,26,4395500,856,416,440
1483,21,26,4395600,4,3,1
1484,21,26,4395700,0,0,0
1485,21,26,4395800,0,0,0
1486,21,26,4395900,141,69,72
1487,21,26,4396000,0,0,0
1488,21,26,4396100,0,0,0
1489,21,26,4396200,44,22,22
1490,21,26,4396300,0,0,0
1491,21,26,4396400,0,0,0
1492,21,26,4396500,155,72,83
1493,21,26,4396600,80,46,34
1494,21,26,4396700,54,25,29
1495,21,26,4396800,371,178,193
1496,21,26,4396900,569,264,305
1497,21,26,4397000,54,22,32
1498,21,26,4397100,258,120,138
1499,21,26,4397200,112,59,53
1500,21,26,4397300,98,44,54
1501,21,26,4397400,135,64,71
1502,21,26,4397500,15,8,7
1503,21,26,4397600,680,315,365
1504,21,26,4397700,425,203,222
1505,21,26,4397800,612,314,298
1506,21,26,4397900,24,11,13
1507,21,26,4398000,25,9,16
1508,21,26,4398100,74,37,37
1509,21,26,4398200,88,41,47
1510,21,26,4398300,2,1,1
1511,21,26,4398400,81,41,40
1512,21,26,4398500,0,0,0
1513,21,26,4398600,20,7,13
1514,21,26,4398700,0,0,0
1515,21,26,4398800,40,21,19
1516,21,26,4398900,122,66,56
1517,21,26,4399000,129,57,72
1518,21,26,4399100,79,34,45
1519,21,26,4399200,34,17,17
1520,21,26,4399300,22,9,13
1521,21,26,4399400,34,17,17
1522,21,26,4399500,17,8,9
1523,21,26,4399600,62,30,32
1524,21,26,4399700,101,50,51
1525,21,26,4399800,35,16,19
1526,21,26,4399900,129,61,68
1527,21,26,4400000,157,67,90
1528,21,26,4400100,47,21,26
1529,21,26,4400200,60,33,27
1530,21,26,4400300,135,68,67
1531,21,26,4400400,199,101,98
1532,21,26,4400500,157,64,93
1533,21,26,4400600,337,171,166
1534,21,26,4400700,407,230,177
1535,21,26,4400800,120,66,54
1536,21,26,4400900,275,125,150
1537,21,26,4401000,89,44,45
1538,21,26,4401100,301,141,160
1539,21,26,4401200,109,47,62
1540,21,26,4401300,89,42,47
1541,21,26,4401400,55,24,31
1542,21,26,4401500,492,227,265
1543,21,26,4401600,177,87,90
1544,21,26,4401700,247,127,120
1545,21,26,4401800,66,34,32
1546,21,26,4401900,105,55,50
1547,21,26,4402000,172,80,92
1548,21,26,4402100,275,155,120
1549,21,26,4402200,69,29,40
1550,21,26,4402300,110,54,56
1551,21,26,4402400,101,49,52
1552,21,26,4402500,119,60,59
1553,21,26,4402600,42,18,24
1554,21,26,4402700,0,0,0
1555,21,26,4402800,188,82,106
1556,21,26,4402900,479,237,242
1557,21,26,4403000,0,0,0
1558,21,26,4403100,175,87,88
1559,21,26,4403200,87,44,43
1560,21,26,4403300,0,0,0
1561,21,26,4403400,299,144,155
1562,21,26,4403500,208,103,105
1563,21,26,4403600,193,94,99
1564,21,26,4403700,100,49,51
1565,21,26,4403800,0,0,0
1566,21,26,4403900,94,48,46
1567,21,26,4404000,242,110,132
1568,21,26,4404100,89,41,48
1569,21,26,4404200,103,42,61
1570,21,26,4404300,0,0,0
1571,21,26,4404400,66,30,36
1572,21,26,4404500,366,161,205
1573,21,26,4404600,151,70,81
1574,21,26,4404700,85,51,34
1575,21,26,4404800,20,9,11
1576,21,26,4404900,144,67,77
1577,21,26,4405000,508,245,263
1578,21,26,4405100,270,140,130
1579,21,26,4405200,77,34,43
1580,21,26,4405300,56,29,27
1581,21,26,4405400,0,0,0
1582,21,26,4405500,93,47,46
1583,21,26,4405600,244,116,128
1584,21,26,4405700,60,30,30
1585,21,26,4405800,73,28,45
1586,21,26,4405900,187,86,101
1587,21,26,4406000,73,33,40
1588,21,26,4406100,77,38,39
1589,21,26,4406200,31,12,19
1590,21,26,4406300,145,68,77
1591,21,26,4406400,25,10,15
1592,21,26,4406500,53,23,30
1593,21,26,4406600,237,105,132
1594,21,26,4406700,800,403,397
1595,21,26,4406800,211,99,112
1596,21,26,4406900,265,118,147
1597,21,26,4407000,420,197,223
1598,21,26,4407100,128,61,67
1599,21,26,4407200,675,362,313
1600,21,26,4407300,79,38,41
1601,21,26,4407400,190,90,100
1602,21,26,4407500,48,27,21
1603,21,26,4407600,21,10,11
1604,21,26,4407700,422,187,235
1605,21,26,4407800,40,20,20
1606,21,26,4407900,86,36,50
1607,21,26,4408000,301,134,167
1608,21,26,4408100,266,128,138
1609,21,26,4408200,164,83,81
1610,21,26,4408300,276,133,143
1611,21,26,4408400,0,0,0
1612,21,26,4408500,167,81,86
1613,21,26,4408600,216,113,103
1614,21,26,4408700,105,60,45
1615,21,26,4408800,426,193,233
1616,21,26,4408900,81,37,44
1617,21,26,4409000,480,245,235
1618,21,26,4409100,0,0,0
1619,21,26,4409200,162,72,90
1620,21,26,4409300,22,11,11
1621,21,26,4409400,14,7,7
1622,21,26,4409500,21,8,13
1623,21,26,4409600,657,347,310
1624,21,26,4409700,234,123,111
1625,21,26,4409800,62,29,33
1626,21,26,4409900,21,8,13
1627,21,26,4410000,0,0,0
1628,21,26,4410100,140,66,74
1629,21,26,4410200,188,99,89
1630,21,26,4410300,460,223,237
1631,21,26,4410400,80,68,12
1632,21,26,4410500,282,133,149
1633,21,26,4410600,95,47,48
1634,21,26,4410700,24,12,12
1635,21,26,4410800,47,22,25
1636,21,26,4410900,105,46,59
1637,21,26,4411000,18,11,7
1638,21,26,4411100,38,21,17
1639,21,26,4411200,95,50,45
1640,21,26,4411300,179,85,94
1641,21,26,4411400,406,206,200
1642,21,26,4411500,188,95,93
1643,21,26,4411600,90,47,43
1644,21,26,4411700,109,53,56
1645,21,26,4411800,56,31,25
1646,21,26,4411900,236,122,114
1647,21,26,4412000,486,237,249
1648,21,26,4412100,171,85,86
1649,21,26,4412200,590,297,293
1650,21,26,4412300,342,164,178
1651,21,26,4412400,208,105,103
1652,21,26,4412500,782,381,401
1653,21,26,4412600,393,197,196
1654,21,26,4412700,592,291,301
1655,21,26,4412800,432,356,76
1656,21,26,4412900,49,25,24
1657,21,26,4413000,884,432,452
1658,21,26,4413100,139,67,72
1659,21,26,4413200,344,181,163
1660,21,26,4413300,0,0,0
1661,21,26,4413400,193,95,98
1662,21,26,4413500,135,59,76
1663,21,26,4413600,68,33,35
1664,21,26,4413700,108,61,47
1665,21,26,4413800,30,11,19
1666,21,26,4413900,141,68,73
1667,21,26,4414000,420,218,202
1668,21,26,4414100,107,48,59
1669,21,26,4414200,196,95,101
1670,21,26,4414300,179,83,96
1671,21,26,4414400,55,27,28
1672,21,26,4414500,217,107,110
1673,21,26,4414600,85,35,50
1674,21,26,4414700,105,62,43
1675,21,26,4414800,44,21,23
1676,21,26,4414900,218,105,113
1677,21,26,4415000,304,144,160
1678,21,26,4415100,138,62,76
1679,21,26,4415200,109,55,54
1680,21,26,4415300,30,14,16
1681,21,26,4415400,116,53,63
1682,21,26,4415500,183,75,108
1683,21,26,4415600,75,40,35
1684,21,26,4415700,194,105,89
1685,21,26,4415800,285,144,141
1686,21,26,4415900,292,135,157
1687,21,26,4416000,0,0,0
1688,21,26,4416100,75,43,32
1689,21,26,4416200,191,99,92
1690,21,26,4416300,232,108,124
1691,21,26,4416400,181,83,98
1692,21,26,4416500,66,33,33
1693,21,26,4416600,0,0,0
1694,21,26,4416700,242,120,122
1695,21,26,4416800,357,161,196
1696,21,26,4416900,0,0,0
1697,21,26,4417000,262,139,123
1698,21,26,4417100,0,0,0
1699,21,26,4417200,29,17,12
1700,21,26,4417300,332,159,173
1701,21,26,4417400,20,10,10
1702,21,26,4417500,207,99,108
1703,21,26,4417600,161,82,79
1704,21,26,4417700,79,38,41
1705,21,26,4417800,75,34,41
1706,21,26,4417900,114,53,61
1707,21,26,4418000,29,11,18
1708,21,26,4418100,132,66,66
1709,21,26,4418200,33,18,15
1710,21,26,4418300,75,34,41
1711,21,26,4418400,227,106,121
1712,21,26,4418500,60,34,26
1713,21,26,4418600,190,87,103
1714,21,26,4418700,101,44,57
1715,21,26,4418800,83,36,47
1716,21,26,4418900,85,36,49
1717,21,26,4419000,497,240,257
1718,21,26,4419100,0,0,0
1719,21,26,4419200,440,224,216
1720,21,26,4419300,240,129,111
1721,21,26,4419400,100,51,49
1722,21,26,4419500,67,25,42
1723,21,26,4419600,56,25,31
1724,21,26,4419700,54,23,31
1725,21,26,4419800,180,80,100
1726,21,26,4419900,110,55,55
1727,21,26,4420000,129,62,67
1728,21,26,4420100,374,173,201
1729,21,26,4420200,380,180,200
1730,21,26,4420300,260,122,138
1731,21,26,4420400,179,83,96
1732,21,26,4420500,318,151,167
1733,21,26,4420600,315,158,157
1734,21,26,4420700,151,74,77
1735,21,26,4420800,183,96,87
1736,21,26,4420900,114,51,63
1737,21,26,4421000,224,94,130
1738,21,26,4421100,95,53,42
1739,21,26,4421200,283,132,151
1740,21,26,4421300,472,210,262
1741,21,26,4421400,166,76,90
1742,21,26,4421500,212,101,111
1743,21,26,4421600,369,264,105
1744,21,26,4421700,242,140,102
1745,21,26,4421800,368,172,196
1746,21,26,4421900,453,226,227
1747,21,26,4422000,49,28,21
1748,21,26,4422100,303,140,163
1749,21,26,4422200,550,154,396
1750,21,26,4422300,414,203,211
1751,21,26,4422400,265,132,133
1752,21,26,4422500,404,196,208
1753,21,26,4422600,383,179,204
1754,21,26,4422700,249,125,124
1755,21,26,4422800,429,250,179
1756,21,26,4422900,74,29,45
1757,21,26,4423000,179,89,90
1758,21,26,4423100,721,347,374
1759,21,26,4423200,72,33,39
1760,21,26,4423300,310,142,168
1761,21,26,4423400,266,122,144
1762,21,26,4423500,128,64,64
1763,21,26,4423600,2629,1392,1237
1764,21,26,4423700,789,380,409
1765,21,26,4423800,379,185,194
1766,21,26,4423900,154,77,77
1767,21,26,4424000,380,197,183
1768,21,26,4424100,204,100,104
1769,21,26,4424200,80,37,43
1770,21,26,4424300,206,96,110
1771,21,26,4424400,149,81,68
1772,21,26,4424500,811,525,286
1773,21,26,4424600,452,216,236
1774,21,26,4424700,547,243,304
1775,21,26,4424800,336,165,171
1776,21,26,4424900,214,98,116
1777,21,26,4425000,416,206,210
1778,21,26,4425100,404,190,214
1779,21,26,4425200,147,77,70
1780,21,26,4425300,714,340,374
1781,21,26,4425400,665,314,351
1782,21,26,4425500,217,103,114
1783,21,26,4425600,441,263,178
1784,21,26,4425700,212,103,109
1785,21,26,4425800,301,144,157
1786,21,26,4425900,637,314,323
1787,21,26,4426000,105,44,61
1788,21,26,4426100,246,125,121
1789,21,26,4426200,552,283,269
1790,21,26,4426300,185,96,89
1791,21,26,4426400,271,128,143
1792,21,26,4426500,68,31,37
1793,21,26,4426600,193,88,105
1794,21,26,4426700,153,77,76
1795,21,26,4426800,657,314,343
1796,21,26,4426900,263,127,136
1797,21,26,4427000,785,376,409
1798,21,26,4427100,706,334,372
1799,21,26,4427200,543,253,290
1800,21,26,4427300,466,232,234
1801,21,26,4427400,291,142,149
1802,21,26,4427500,1564,768,796
1803,21,26,4427600,94,46,48
1804,21,26,4427700,591,383,208
1805,21,26,4427800,236,119,117
1806,21,26,4427900,691,338,353
1807,21,26,4428000,550,270,280
1808,21,26,4428100,544,260,284
1809,21,26,4428200,231,127,104
1810,21,26,4428300,583,288,295
1811,21,26,4428400,545,268,277
1812,21,26,4428500,387,181,206
1813,21,26,4428600,916,445,471
1814,21,26,4428700,154,73,81
1815,21,26,4428800,624,288,336
1816,21,26,4428900,1120,554,566
1817,21,26,4429000,85,43,42
1818,21,26,4429100,89,44,45
1819,21,26,4429200,207,107,100
1820,21,26,4429300,154,69,85
1821,21,26,4429400,51,24,27
1822,21,26,4429500,86,42,44
1823,21,26,4429600,513,245,268
1824,21,26,4429700,80,37,43
1825,21,26,4429800,0,0,0
1826,21,26,4429900,257,133,124
1827,21,26,4430000,1386,707,679
1828,21,26,4430100,279,132,147
1829,21,26,4430200,308,145,163
1830,21,26,4430300,578,271,307
1831,21,26,4430400,1174,551,623
1832,21,26,4430500,93,47,46
1833,21,26,4430600,673,323,350
1834,21,26,4430700,585,294,291
1835,21,26,4430800,89,44,45
1836,21,26,4430900,170,83,87
1837,21,26,4431000,288,127,161
1838,21,26,4431100,355,174,181
1839,21,26,4431200,449,243,206
1840,21,26,4431300,223,110,113
1841,21,26,4431400,0,0,0
1842,21,26,4431500,140,64,76
1843,21,26,4431600,265,133,132
1844,21,26,4431700,174,76,98
1845,21,26,4431800,0,0,0
1846,21,26,4431900,357,168,189
1847,21,26,4432000,145,70,75
1848,21,26,4432100,212,105,107
1849,21,26,4432200,205,105,100
1850,21,26,4432300,59,31,28
1851,21,26,4432400,466,229,237
1852,21,26,4432500,127,63,64
1853,21,26,4432600,237,120,117
1854,21,26,4432700,116,56,60
1855,21,26,4432800,377,177,200
1856,21,26,4432900,177,86,91
1857,21,26,4433000,578,272,306
1858,21,26,4433100,427,206,221
1859,21,26,4433200,0,0,0
1860,21,26,4433300,0,0,0
1861,21,26,4433400,578,277,301
1862,21,26,4433500,343,178,165
1863,21,26,4433600,0,0,0
1864,21,26,4433700,128,62,66
1865,21,26,4433800,83,40,43
1866,21,26,4433900,2,1,1
1867,21,26,4434000,0,0,0
1868,21,26,4434100,617,303,314
1869,21,26,4434200,119,57,62
1870,21,26,4434300,126,61,65
1871,21,26,4434400,227,116,111
1872,21,26,4434500,100,44,56
1873,21,26,4434600,0,0,0
1874,21,26,4434700,0,0,0
1875,21,26,4434800,279,125,154
1876,21,26,4434900,420,196,224
1877,21,26,4435000,46,25,21
1878,21,26,4435100,0,0,0
1879,21,26,4435200,0,0,0
1880,21,26,4435300,311,146,165
1881,21,26,4435400,92,44,48
1882,21,26,4435500,24,10,14
1883,21,26,4435600,89,43,46
1884,21,26,4435700,394,183,211
1885,21,26,4435800,141,70,71
1886,21,26,4435900,245,113,132
1887,21,26,4436000,1445,717,728
1888,21,26,4436100,2739,1331,1408
1889,21,26,4436200,242,129,113
1890,21,26,4436300,136,68,68
1891,21,26,4436400,309,147,162
1892,21,26,4436500,212,106,106
1893,21,26,4436600,433,211,222
1894,21,26,4436700,1026,513,513
1895,21,26,4436800,3627,1807,1820
1896,21,26,4436900,695,350,345
1897,21,26,4437000,2870,1462,1408
1898,21,26,4437100,1880,959,921
1899,21,26,4437200,1433,759,674
1900,21,26,4437300,1075,545,530
1901,21,26,4437400,638,316,322
1902,21,26,4437500,1336,668,668
1903,21,26,4437600,677,354,323
1904,21,26,4437700,613,317,296
1905,21,26,4437800,592,295,297
1906,21,26,4437900,1899,951,948
1907,21,26,4438000,1767,889,878
1908,21,26,4438100,2185,1055,1130
1909,21,26,4438200,1560,780,780
1910,21,26,4438300,1662,813,849
1911,21,26,4438400,942,459,483
1912,21,26,4438500,0,0,0
1913,21,26,4438600,154,77,77
1914,21,26,4438700,530,258,272
1915,21,26,4438800,1205,616,589
1916,21,26,4438900,1200,578,622
1917,21,26,4439000,2427,1183,1244
1918,21,26,4439100,935,481,454
1919,21,26,4439200,417,194,223
1920,21,26,4439300,1498,755,743
1921,21,26,4439400,552,269,283
1922,21,26,4439500,68,33,35
1923,21,26,4439600,207,96,111
1924,21,26,4439700,344,174,170
1925,21,26,4439800,977,488,489
1926,21,26,4439900,1067,536,531
1927,21,26,4440000,1186,578,608
1928,21,26,4440100,969,473,496
1929,21,26,4440200,1337,660,677
1930,21,26,4440300,1875,926,949
1931,21,26,4440400,386,198,188
1932,21,26,4440500,936,471,465
1933,21,26,4440600,1096,517,579
1934,21,26,4440700,219,116,103
1935,21,26,4440800,1375,671,704
1936,21,26,4440900,713,345,368
1937,21,26,4441000,586,283,303
1938,21,26,4441100,859,432,427
1939,21,26,4441200,710,356,354
1940,21,26,4441300,63,36,27
1941,21,26,4441400,451,229,222
1942,21,26,4441500,974,485,489
1943,21,26,4441600,889,438,451
1944,21,26,4441700,360,256,104
1945,21,26,4441800,658,319,339
1946,21,26,4441900,1288,616,672
1947,21,26,4442000,2157,1055,1102
1948,21,26,4442100,2393,1193,1200
1949,21,26,4442200,891,442,449
1950,21,26,4442300,1505,767,738
1951,21,26,4442400,2445,1186,1259
1952,21,26,4442500,2318,1160,1158
1953,21,26,4442600,1272,638,634
1954,21,26,4442700,923,474,449
1955,21,26,4442800,552,271,281
1956,21,26,4442900,2568,1290,1278
1957,21,26,4443000,221,99,122
1958,21,26,4443100,1102,572,530
1959,21,26,4443200,1236,632,604
1960,21,26,4443300,916,461,455
1961,21,26,4443400,1298,645,653
1962,21,26,4443500,0,0,0
1963,21,26,4443600,0,0,0
1964,21,26,4443700,3284,1669,1615
1965,21,26,4443800,3491,1785,1706
1966,21,26,4443900,1204,608,596
1967,21,26,4444000,1186,592,594
1968,21,26,4444100,2886,1480,1406
1969,21,26,4444200,962,500,462
1970,21,26,4444300,1166,591,575
1971,21,26,4444400,2555,1308,1247
1972,21,26,4444500,822,401,421
1973,21,26,4444600,1591,794,797
1974,21,26,4444700,439,212,227
1975,21,26,4444800,745,355,390
1976,21,26,4444900,891,448,443
1977,21,26,4445000,2203,1087,1116
1978,21,26,4445100,1632,806,826
1979,21,26,4445200,968,475,493
1980,21,26,4445300,210,105,105
1981,21,26,4445400,887,440,447
1982,21,26,4445500,7,2,5
1983,21,26,4445600,791,397,394
1984,21,26,4445700,621,332,289
1985,21,26,4445800,127,67,60
1986,21,26,4445900,54,23,31
1987,21,26,4446000,884,447,437
1988,21,26,4446100,196,103,93
1989,21,26,4446200,1137,554,583
1990,21,26,4446300,590,301,289
1991,21,26,4446400,187,90,97
1992,21,26,4446500,242,115,127
1993,21,26,4446600,1016,497,519
1994,21,26,4446700,719,375,344
1995,21,26,4446800,920,455,465
1996,21,26,4446900,0,0,0
1997,21,26,4447000,135,62,73
1998,21,26,4447100,36,16,20
1999,21,26,4447200,435,221,214
2000,21,26,4447300,566,279,287
2001,21,26,4447400,250,119,131
2002,21,26,4447500,210,108,102
2003,21,26,4447600,74,35,39
2004,21,26,4447700,0,0,0
2005,21,26,4447800,221,113,108
2006,21,26,4447900,77,41,36
2007,21,26,4448000,218,103,115
2008,21,26,4448100,81,37,44
2009,21,26,4448200,1773,884,889
2010,21,26,4448300,554,278,276
2011,21,26,4448400,1103,534,569
2012,21,26,4448500,24,14,10
2013,21,26,4448600,754,367,387
2014,21,26,4448700,317,172,145
2015,21,26,4448800,438,193,245
2016,21,26,4448900,929,468,461
2017,21,26,4449000,233,116,117
2018,21,26,4449100,1105,547,558
2019,21,26,4449200,598,306,292
2020,21,26,4449300,2431,1181,1250
2021,21,26,4449400,1583,781,802
2022,21,26,4449500,1533,775,758
2023,21,26,4449600,2282,1128,1154
2024,21,26,4449700,780,380,400
2025,21,26,4449800,2347,1194,1153
2026,21,26,4449900,4315,2216,2099
2027,21,26,4450000,1321,647,674
2028,21,26,4450100,1219,598,621
2029,21,26,4450200,123,57,66
2030,21,26,4450300,1915,949,966
2031,21,26,4450400,815,410,405
2032,21,26,4450500,2503,1266,1237
2033,21,26,4450600,2714,1353,1361
2034,21,26,4450700,2648,1346,1302
2035,21,26,4450800,1220,598,622
2036,21,26,4450900,676,338,338
2037,21,26,4451000,1320,631,689
2038,21,26,4451100,772,396,376
2039,21,26,4451200,1662,804,858
2040,21,26,4451300,3010,1520,1490
2041,21,26,4451400,1621,825,796
2042,21,26,4451500,2452,1194,1258
2043,21,26,4451600,985,494,491
2044,21,26,4451700,624,332,292
2045,21,26,4451800,1190,611,579
2046,21,26,4451900,2239,1113,1126
2047,21,26,4452000,1517,765,752
2048,21,26,4452100,0,0,0
2049,21,26,4452200,1007,512,495
2050,21,26,4452300,1722,832,890
2051,21,26,4452400,760,382,378
2052,21,26,4452500,66,33,33
2053,21,26,4452600,1140,557,583
2054,21,26,4452700,1196,608,588
2055,21,26,4452800,799,390,409
2056,21,26,4452900,408,205,203
2057,21,26,4453000,1577,766,811
2058,21,26,4453100,735,375,360
2059,21,26,4453200,652,301,351
2060,21,26,4453300,167,74,93
2061,21,26,4453400,292,149,143
2062,21,26,4453500,53,33,20
2063,21,26,4453600,122,68,54
2064,21,26,4453700,1109,552,557
2065,21,26,4453800,564,275,289
2066,21,26,4453900,732,338,394
2067,21,26,4454000,0,0,0
2068,21,26,4454100,880,430,450
2069,21,26,4454200,1427,690,737
2070,21,26,4454300,376,190,186
2071,21,26,4454400,8,3,5
2072,21,26,4454500,93,46,47
2073,21,26,4454600,205,105,100
2074,21,26,4454700,46,24,22
2075,21,26,4454800,20,14,6
2076,21,26,4454900,347,172,175
2077,21,26,4455000,1544,760,784
2078,21,26,4455100,1644,846,798
2079,21,26,4455200,1245,649,596
2080,21,26,4455300,1455,732,723
2081,21,26,4455400,1485,710,775
2082,21,26,4455500,3755,1900,1855
2083,21,26,4455600,878,432,446
2084,21,26,4455700,1468,700,768
2085,21,26,4455800,454,206,248
2086,21,26,4455900,158,85,73
2087,21,26,4456000,88,40,48
2088,21,26,4456100,531,263,268
2089,21,26,4456200,139,70,69
2090,21,26,4456300,114,53,61
2091,21,26,4456400,1973,949,1024
2092,21,26,4456500,233,115,118
2093,21,26,4456600,1138,552,586
2094,21,26,4456700,1359,676,683
2095,21,26,4456800,1551,771,780
2096,21,26,4456900,1147,595,552
2097,21,26,4457000,1074,532,542
2098,21,26,4457100,1593,809,784
2099,21,26,4457200,133,67,66
2100,21,26,4457300,1746,883,863
2101,21,26,4457400,939,475,464
2102,21,26,4457500,1189,580,609
2103,21,26,4457600,2340,1095,1245
2104,21,26,4457700,1973,982,991
2105,21,26,4457800,1360,674,686
2106,21,26,4457900,1742,883,859
2107,21,26,4458000,2087,1029,1058
2108,21,26,4458100,3339,1654,1685
2109,21,26,4458200,971,475,496
2110,21,26,4458300,874,448,426
2111,21,26,4458400,1428,720,708
2112,21,26,4458500,1494,733,761
2113,21,26,4458600,1305,656,649
2114,21,26,4458700,1232,583,649
2115,21,26,4458800,906,440,466
2116,21,26,4458900,1923,951,972
2117,21,26,4459000,600,314,286
2118,21,26,4459100,270,139,131
2119,21,26,4459200,234,126,108
2120,21,26,4459300,152,82,70
2121,21,26,4459400,941,479,462
2122,21,26,4459500,866,423,443
2123,21,26,4459600,952,472,480
2124,21,26,4459700,3350,1700,1650
2125,21,26,4459800,1630,817,813
2126,21,26,4459900,899,417,482
2127,21,26,4460000,965,485,480
2128,21,26,4460100,500,244,256
2129,21,26,4460200,781,379,402
2130,21,26,4460300,941,472,469
2131,21,26,4460400,1591,799,792
2132,21,26,4460500,1735,847,888
2133,21,26,4460600,1259,628,631
2134,21,26,4460700,694,343,351
2135,21,26,4460800,911,448,463
2136,21,26,4460900,507,245,262
2137,21,26,4461000,547,266,281
2138,21,26,4461100,67,33,34
2139,21,26,4461200,422,204,218
2140,21,26,4461300,168,81,87
2141,21,26,4461400,919,456,463
2142,21,26,4461500,455,217,238
2143,21,26,4461600,1903,932,971
2144,21,26,4461700,1168,608,560
2145,21,26,4461800,1318,663,655
2146,21,26,4461900,3602,1767,1835
2147,21,26,4462000,2010,975,1035
2148,21,26,4462100,968,461,507
2149,21,26,4462200,954,451,503
2150,21,26,4462300,800,393,407
2151,21,26,4462400,2335,1212,1123
2152,21,26,4462500,2027,1011,1016
2153,21,26,4462600,2999,1402,1597
2154,21,26,4462700,707,328,379
2155,21,26,4462800,1185,590,595
2156,21,26,4462900,2075,983,1092
2157,21,26,4463000,2078,1017,1061
2158,21,26,4463100,1661,808,853
2159,21,26,4463200,2206,1101,1105
2160,21,26,4463300,2271,1133,1138
2161,21,26,4463400,780,395,385
2162,21,26,4463500,2290,1109,1181
2163,21,26,4463600,101,55,46
2164,21,26,4463700,746,358,388
2165,21,26,4463800,441,204,237
2166,21,26,4463900,2910,1486,1424
2167,21,26,4464000,415,217,198
2168,21,26,4464100,985,480,505
2169,21,26,4464200,1862,919,943
2170,21,26,4464300,1748,876,872
2171,21,26,4464400,900,435,465
2172,21,26,4464500,591,278,313
2173,21,26,4464600,400,201,199
2174,21,26,4464700,281,127,154
2175,21,26,4464800,778,374,404
2176,21,26,4464900,604,297,307
2177,21,26,4465000,1308,611,697
2178,21,26,4465100,2290,1145,1145
2179,21,26,4465200,1227,591,636
2180,21,26,4465300,1164,559,605
2181,21,26,4465400,4201,2082,2119
2182,21,26,4465500,3353,1673,1680
2183,21,26,4465600,3490,1708,1782
2184,21,26,4465700,321,152,169
2185,21,26,4465800,1457,720,737
2186,21,26,4465900,736,355,381
2187,21,26,4466000,1138,557,581
2188,21,26,4466100,230,106,124
2189,21,26,4466200,978,465,513
2190,21,26,4466300,997,464,533
2191,21,26,4466400,1118,559,559
2192,21,26,4466500,201,99,102
2193,21,26,4466600,1460,696,764
2194,21,26,4466700,660,322,338
2195,21,26,4466800,1040,506,534
2196,21,26,4466900,951,467,484
2197,21,26,4467000,1067,530,537
2198,21,26,4467100,2176,1140,1036
2199,21,26,4467200,1318,644,674
2200,21,26,4467300,863,410,453
2201,21,26,4467400,1647,814,833
2202,21,26,4467500,898,430,468
2203,21,26,4467600,407,192,215
2204,21,26,4467700,753,360,393
2205,21,26,4467800,983,497,486
2206,21,26,4467900,1799,864,935
2207,21,26,4468000,10901,5558,5343
2208,21,26,4468100,3709,1850,1859
2209,21,26,4468200,2636,1292,1344
2210,21,26,4468300,1577,762,815
2211,21,26,4468400,3329,1662,1667
2212,21,26,4468500,3163,1585,1578
2213,21,26,4468600,2080,1004,1076
2214,21,26,4468700,1372,673,699
2215,21,26,4468800,742,371,371
2216,21,26,4468900,464,229,235
2217,21,26,4469000,602,288,314
2218,21,26,4469100,273,153,120
2219,21,26,4469200,618,284,334
2220,21,26,4469300,682,330,352
2221,21,26,4469400,950,468,482
2222,21,26,4469500,622,291,331
2223,21,26,4469600,363,178,185
2224,21,26,4469700,577,266,311
2225,21,26,4469800,1420,695,725
2226,21,26,4469900,578,279,299
2227,21,26,4470000,1425,729,696
2228,21,26,4470100,690,361,329
2229,21,26,4470200,703,338,365
2230,21,26,4470300,369,184,185
2231,21,26,4470400,0,0,0
2232,21,26,4470500,25,15,10
2233,21,26,4470600,975,492,483
2234,21,26,4470700,648,317,331
2235,21,26,4470800,876,416,460
