,Statecode,Districtcode,VillageCode,Population,Males,Females
0,21,388,3049400,997,492,505
1,21,388,3049500,180,92,88
2,21,388,3049600,79,36,43
3,21,388,3049700,113,58,55
4,21,388,3049800,495,265,230
5,21,388,3049900,173,87,86
6,21,388,3050000,137,70,67
7,21,388,3050100,142,72,70
8,21,388,3050200,1206,701,505
9,21,388,3050300,359,170,189
10,21,388,3050400,115,59,56
11,21,388,3050500,254,118,136
12,21,388,3050600,709,361,348
13,21,388,3050700,971,509,462
14,21,388,3050800,2311,1164,1147
15,21,388,3050900,767,378,389
16,21,388,3051000,290,151,139
17,21,388,3051100,376,213,163
18,21,388,3051200,3521,1804,1717
19,21,388,3051300,741,378,363
20,21,388,3051400,1162,559,603
21,21,388,3051500,527,261,266
22,21,388,3051600,1570,810,760
23,21,388,3051700,231,120,111
24,21,388,3051800,471,257,214
25,21,388,3051900,1125,567,558
26,21,388,3052000,942,458,484
27,21,388,3052100,3182,1606,1576
28,21,388,3052200,1143,566,577
29,21,388,3052300,2271,1153,1118
30,21,388,3052400,23,13,10
31,21,388,3052500,654,330,324
32,21,388,3052600,1449,740,709
33,21,388,3052700,620,310,310
34,21,388,3052800,870,435,435
35,21,388,3052900,60,24,36
36,21,388,3053000,1923,951,972
37,21,388,3053100,681,372,309
38,21,388,3053200,4777,2408,2369
39,21,388,3053300,489,254,235
40,21,388,3053400,1881,934,947
41,21,388,3053500,326,164,162
42,21,388,3053600,709,375,334
43,21,388,3053700,1969,1033,936
44,21,388,3053800,367,183,184
45,21,388,3053900,1776,880,896
46,21,388,3054000,515,253,262
47,21,388,3054100,1033,486,547
48,21,388,3054200,1579,812,767
49,21,388,3054300,414,206,208
50,21,388,3054400,2,1,1
51,21,388,3054500,1080,532,548
52,21,388,3054600,818,414,404
53,21,388,3054700,346,177,169
54,21,388,3054800,502,238,264
55,21,388,3054900,2243,1141,1102
56,21,388,3055000,644,304,340
57,21,388,3055100,314,157,157
58,21,388,3055200,580,284,296
59,21,388,3055300,1846,861,985
60,21,388,3055400,0,0,0
61,21,388,3055500,32,16,16
62,21,388,3055600,60,27,33
63,21,388,3055700,416,211,205
64,21,388,3055800,53,21,32
65,21,388,3055900,2,1,1
66,21,388,3056000,7,4,3
67,21,388,3056100,828,396,432
68,21,388,3056200,0,0,0
69,21,388,3056300,59,30,29
70,21,388,3056400,864,435,429
71,21,388,3056500,504,245,259
72,21,388,3056600,328,168,160
73,21,388,3056700,590,309,281
74,21,388,3056800,71,35,36
75,21,388,3056900,690,336,354
76,21,388,3057000,1767,817,950
77,21,388,3057100,1340,657,683
78,21,388,3057200,1553,789,764
79,21,388,3057300,17,7,10
80,21,388,3057400,1563,762,801
81,21,388,3057500,317,167,150
82,21,388,3057600,1106,540,566
83,21,388,3057700,390,173,217
84,21,388,3057800,62,32,30
85,21,388,3057900,0,0,0
86,21,388,3058000,350,185,165
87,21,388,3058100,5537,2772,2765
88,21,388,3058200,96,49,47
89,21,388,3058300,390,196,194
90,21,388,3058400,380,195,185
91,21,388,3058500,870,462,408
92,21,388,3058600,101,48,53
93,21,388,3058700,8,4,4
94,21,388,3058800,715,337,378
95,21,388,3058900,800,408,392
96,21,388,3059000,873,410,463
97,21,388,3059100,357,186,171
98,21,388,3059200,1415,659,756
99,21,388,3059300,443,228,215
100,21,388,3059400,84,30,54
101,21,388,3059500,312,147,165
102,21,388,3059600,1409,706,703
103,21,388,3059700,525,247,278
104,21,388,3059800,1033,524,509
105,21,388,3059900,733,372,361
106,21,388,3060000,451,215,236
107,21,388,3060100,269,132,137
108,21,388,3060200,66,37,29
109,21,388,3060300,79,36,43
110,21,388,3060400,238,120,118
111,21,388,3060500,671,337,334
112,21,388,3060600,1498,772,726
113,21,388,3060700,203,102,101
114,21,388,3060800,200,96,104
115,21,388,3060900,3086,1527,1559
116,21,388,3061000,2477,1238,1239
117,21,388,3061100,753,382,371
118,21,388,3061200,223,119,104
119,21,388,3061300,371,189,182
120,21,388,3061400,733,371,362
121,21,388,3061500,496,235,261
122,21,388,3061600,2160,1065,1095
123,21,388,3061700,556,263,293
124,21,388,3061800,878,420,458
125,21,388,3061900,679,357,322
126,21,388,3062000,130,69,61
127,21,388,3062100,493,241,252
128,21,388,3062200,61,33,28
129,21,388,3062300,104,58,46
130,21,388,3062400,0,0,0
131,21,388,3062500,0,0,0
132,21,388,3062600,29,15,14
133,21,388,3062700,1390,716,674
134,21,388,3062800,112,53,59
135,21,388,3062900,4836,2488,2348
136,21,388,3063000,7,4,3
137,21,388,3063100,2298,1148,1150
138,21,388,3063200,1595,794,801
139,21,388,3063300,426,209,217
140,21,388,3063400,650,332,318
141,21,388,3063500,2079,1064,1015
142,21,388,3063600,377,184,193
143,21,388,3063700,51,21,30
144,21,388,3063800,629,310,319
145,21,388,3063900,1533,748,785
146,21,388,3064000,626,304,322
147,21,388,3064100,2265,1105,1160
148,21,388,3064200,3839,1995,1844
149,21,388,3064300,62,35,27
150,21,388,3064400,282,138,144
151,21,388,3064500,2813,1376,1437
152,21,388,3064600,2031,999,1032
153,21,388,3064700,209,109,100
154,21,388,3064800,181,96,85
155,21,388,3064900,266,130,136
156,21,388,3065000,329,169,160
157,21,388,3065100,181,84,97
158,21,388,3065200,649,321,328
159,21,388,3065300,1333,667,666
160,21,388,3065400,1002,475,527
161,21,388,3065500,362,184,178
162,21,388,3065600,664,304,360
163,21,388,3065700,644,317,327
164,21,388,3065800,759,390,369
165,21,388,3065900,3395,1636,1759
166,21,388,3066000,538,265,273
167,21,388,3066100,841,388,453
168,21,388,3066200,1620,781,839
169,21,388,3066300,1147,548,599
170,21,388,3066400,1067,519,548
171,21,388,3066500,799,417,382
172,21,388,3066600,1619,798,821
173,21,388,3066700,1114,530,584
174,21,388,3066800,1613,807,806
175,21,388,3066900,857,447,410
176,21,388,3067000,1031,523,508
177,21,388,3067100,716,346,370
178,21,388,3067200,1156,595,561
179,21,388,3067300,952,413,539
180,21,388,3067400,297,152,145
181,21,388,3067500,1352,606,746
182,21,388,3067600,1383,671,712
183,21,388,3067700,1209,570,639
184,21,388,3067800,1276,634,642
185,21,388,3067900,3449,1677,1772
186,21,388,3068000,849,445,404
187,21,388,3068100,18,8,10
188,21,388,3068200,102,44,58
189,21,388,3068300,963,503,460
190,21,388,3068400,412,200,212
191,21,388,3068500,174,84,90
192,21,388,3068600,2956,1441,1515
193,21,388,3068700,1449,720,729
194,21,388,3068800,481,240,241
195,21,388,3068900,0,0,0
196,21,388,3069000,769,387,382
197,21,388,3069100,39,21,18
198,21,388,3069200,342,180,162
199,21,388,3069300,215,104,111
200,21,388,3069400,1452,780,672
201,21,388,3069500,35,20,15
202,21,388,3069600,941,483,458
203,21,388,3069700,1913,946,967
204,21,388,3069800,1394,683,711
205,21,388,3069900,1230,606,624
206,21,388,3070000,0,0,0
207,21,388,3070100,754,361,393
208,21,388,3070200,1326,605,721
209,21,388,3070300,1380,661,719
210,21,388,3070400,2254,1047,1207
211,21,388,3070500,635,297,338
212,21,388,3070600,0,0,0
213,21,388,3070700,1345,649,696
214,21,388,3070800,3018,1453,1565
215,21,388,3070900,1455,700,755
216,21,388,3071000,1662,738,924
217,21,388,3071100,1950,946,1004
218,21,388,3071200,345,169,176
219,21,388,3071300,1411,735,676
220,21,388,3071400,1377,658,719
221,21,388,3071500,2008,1062,946
222,21,388,3071600,1649,839,810
223,21,388,3071700,0,0,0
224,21,388,3071800,3130,1498,1632
225,21,388,3071900,0,0,0
226,21,388,3072000,1040,508,532
227,21,388,3072100,1637,827,810
228,21,388,3072200,870,452,418
229,21,388,3072300,1665,773,892
230,21,388,3072400,1696,845,851
231,21,388,3072500,1414,688,726
232,21,388,3072600,446,237,209
233,21,388,3072700,82,41,41
234,21,388,3072800,190,94,96
235,21,388,3072900,54,25,29
236,21,388,3073000,0,0,0
237,21,388,3073100,164,81,83
238,21,388,3073200,241,121,120
239,21,388,3073300,183,98,85
240,21,388,3073400,627,345,282
241,21,388,3073500,3537,1796,1741
242,21,388,3073600,2392,1209,1183
243,21,388,3073700,0,0,0
244,21,388,3073800,1549,770,779
245,21,388,3073900,1043,530,513
246,21,388,3074000,520,261,259
247,21,388,3074100,1257,598,659
248,21,388,3074200,511,244,267
249,21,388,3074300,2559,1250,1309
250,21,388,3074400,1118,539,579
251,21,388,3074500,1426,697,729
252,21,388,3074600,1686,786,900
253,21,388,3074700,1497,767,730
254,21,388,3074800,2140,1041,1099
255,21,388,3074900,905,455,450
256,21,388,3075000,1289,638,651
257,21,388,3075100,113,54,59
258,21,388,3075200,5234,2581,2653
259,21,388,3075300,1097,571,526
260,21,388,3075400,1594,787,807
261,21,388,3075500,336,160,176
262,21,388,3075600,127,62,65
263,21,388,3075700,62,25,37
264,21,388,3075800,291,142,149
265,21,388,3075900,433,205,228
266,21,388,3076000,762,365,397
267,21,388,3076100,358,187,171
268,21,388,3076200,375,180,195
269,21,388,3076300,530,279,251
270,21,388,3076400,2418,1289,1129
271,21,388,3076500,2344,1158,1186
272,21,388,3076600,449,222,227
273,21,388,3076700,71,37,34
274,21,388,3076800,849,396,453
275,21,388,3076900,441,217,224
276,21,388,3077000,69,32,37
277,21,388,3077100,4251,2113,2138
278,21,388,3077200,164,71,93
279,21,388,3077300,824,391,433
280,21,388,3077400,824,417,407
281,21,388,3077500,323,157,166
282,21,388,3077600,1390,679,711
283,21,388,3077700,330,157,173
284,21,388,3077800,90,42,48
285,21,388,3077900,648,315,333
286,21,388,3078000,843,432,411
287,21,388,3078100,55,26,29
288,21,388,3078200,332,168,164
289,21,388,3078300,1491,752,739
290,21,388,3078400,599,309,290
291,21,388,3078500,175,85,90
292,21,388,3078600,382,198,184
293,21,388,3078700,945,465,480
294,21,388,3078800,414,207,207
295,21,388,3078900,346,174,172
296,21,388,3079000,168,87,81
297,21,388,3079100,525,251,274
298,21,388,3079200,2194,1087,1107
299,21,388,3079300,764,374,390
300,21,388,3079400,110,66,44
301,21,388,3079500,121,61,60
302,21,388,3079600,253,130,123
303,21,388,3079700,0,0,0
304,21,388,3079800,767,370,397
305,21,388,3079900,290,146,144
306,21,388,3080000,757,399,358
307,21,388,3080100,129,65,64
308,21,388,3080200,909,465,444
309,21,388,3080300,693,357,336
310,21,388,3080400,178,92,86
311,21,388,3080500,1236,573,663
312,21,388,3080600,1407,702,705
313,21,388,3080700,1129,563,566
314,21,388,3080800,765,382,383
315,21,388,3080900,662,327,335
316,21,388,3081000,1847,961,886
317,21,388,3081100,982,473,509
318,21,388,3081200,1437,753,684
319,21,388,3081300,934,468,466
320,21,388,3081400,1439,705,734
321,21,388,3081500,648,340,308
322,21,388,3081600,0,0,0
323,21,388,3081700,1316,662,654
324,21,388,3081800,5591,2812,2779
325,21,388,3081900,1351,692,659
326,21,388,3082000,7272,3800,3472
327,21,388,3082100,0,0,0
328,21,388,3082200,0,0,0
329,21,388,3082300,2599,1278,1321
330,21,388,3082400,245,121,124
331,21,388,3082500,642,305,337
332,21,388,3082600,2422,1205,1217
333,21,388,3082700,770,382,388
334,21,388,3082800,425,203,222
335,21,388,3082900,1775,895,880
336,21,388,3083000,713,330,383
337,21,388,3083100,218,111,107
338,21,388,3083200,269,132,137
339,21,388,3083300,35,18,17
340,21,388,3083400,1397,757,640
341,21,388,3083500,487,263,224
342,21,388,3083600,527,272,255
343,21,388,3083700,1642,803,839
344,21,388,3083800,502,225,277
345,21,388,3083900,3894,1842,2052
346,21,388,3084000,1468,735,733
347,21,388,3084100,3148,1562,1586
348,21,388,3084200,552,267,285
349,21,388,3084300,1141,571,570
350,21,388,3084400,3242,1634,1608
351,21,388,3084500,1431,724,707
352,21,388,3084600,3083,1572,1511
353,21,388,3084700,1106,522,584
354,21,388,3084800,3294,1702,1592
355,21,388,3084900,685,357,328
356,21,388,3085000,234,116,118
357,21,388,3085100,0,0,0
358,21,388,3085200,1171,598,573
359,21,388,3085300,310,160,150
360,21,388,3085400,1853,909,944
361,21,388,3085500,78,42,36
362,21,388,3085600,0,0,0
363,21,388,3085700,109,54,55
364,21,388,3085800,0,0,0
365,21,388,3085900,144,71,73
366,21,388,3086000,155,80,75
367,21,388,3086100,569,278,291
368,21,388,3086200,1434,734,700
369,21,388,3086300,1335,687,648
370,21,388,3086400,418,190,228
371,21,388,3086500,1602,769,833
372,21,388,3086600,2249,1109,1140
373,21,388,3086700,1933,878,1055
374,21,388,3086800,1646,787,859
375,21,388,3086900,554,286,268
376,21,388,3087000,810,378,432
377,21,388,3087100,1002,485,517
378,21,388,3087200,1863,914,949
379,21,388,3087300,1119,557,562
380,21,388,3087400,184,80,104
381,21,388,3087500,626,286,340
382,21,388,3087600,340,163,177
383,21,388,3087700,1068,525,543
384,21,388,3087800,1903,939,964
385,21,388,3087900,2204,1102,1102
386,21,388,3088000,591,293,298
387,21,388,3088100,784,389,395
388,21,388,3088200,1480,684,796
389,21,388,3088300,2695,1318,1377
390,21,388,3088400,631,293,338
391,21,388,3088500,1550,751,799
392,21,388,3088600,272,135,137
393,21,388,3088700,2189,1038,1151
394,21,388,3088800,1648,817,831
395,21,388,3088900,1279,610,669
396,21,388,3089000,1452,674,778
397,21,388,3089100,676,312,364
398,21,388,3089200,1880,922,958
399,21,388,3089300,838,394,444
400,21,388,3089400,0,0,0
401,21,388,3089500,1773,855,918
402,21,388,3089600,17,8,9
403,21,388,3089700,3636,1731,1905
404,21,388,3089800,532,244,288
405,21,388,3089900,1852,873,979
406,21,388,3090000,541,274,267
407,21,388,3090100,2179,1028,1151
408,21,388,3090200,2253,1118,1135
409,21,388,3090300,535,263,272
410,21,388,3090400,260,133,127
411,21,388,3090500,327,161,166
412,21,388,3090600,520,264,256
413,21,388,3090700,1148,588,560
414,21,388,3090800,427,219,208
415,21,388,3090900,726,353,373
416,21,388,3091000,2511,1222,1289
417,21,388,3091100,1919,959,960
418,21,388,3091200,1210,569,641
419,21,388,3091300,2537,1175,1362
420,21,388,3091400,715,352,363
421,21,388,3091500,381,202,179
422,21,388,3091600,3306,1677,1629
423,21,388,3091700,534,260,274
424,21,388,3091800,981,491,490
425,21,388,3091900,1162,573,589
426,21,388,3092000,327,177,150
427,21,388,3092100,21,14,7
428,21,388,3092200,933,472,461
429,21,388,3092300,1679,759,920
430,21,388,3092400,463,230,233
431,21,388,3092500,334,157,177
432,21,388,3092600,2018,891,1127
433,21,388,3092700,1204,578,626
434,21,388,3092800,637,291,346
435,21,388,3092900,1658,746,912
436,21,388,3093000,954,444,510
437,21,388,3093100,1482,739,743
438,21,388,3093200,779,390,389
439,21,388,3093300,2476,1276,1200
440,21,388,3093400,416,200,216
441,21,388,3093500,771,397,374
442,21,388,3093600,683,294,389
443,21,388,3093700,1097,520,577
444,21,388,3093800,2185,1001,1184
445,21,388,3093900,2895,1434,1461
446,21,388,3094000,792,398,394
447,21,388,3094100,966,503,463
448,21,388,3094200,612,291,321
449,21,388,3094300,1975,987,988
450,21,388,3094400,410,200,210
451,21,388,3094500,1251,607,644
452,21,388,3094600,1813,903,910
453,21,388,3094700,2479,1190,1289
454,21,388,3094800,2225,1075,1150
455,21,388,3094900,2448,1180,1268
456,21,388,3095000,792,376,416
457,21,388,3095100,1428,676,752
458,21,388,3095200,626,305,321
459,21,388,3095300,720,328,392
460,21,388,3095400,2875,1343,1532
461,21,388,3095500,816,387,429
462,21,388,3095600,3129,1549,1580
463,21,388,3095700,1278,625,653
464,21,388,3095800,3250,1538,1712
465,21,388,3095900,1468,779,689
466,21,388,3096000,1462,672,790
467,21,388,3096100,358,184,174
468,21,388,3096200,3188,1556,1632
469,21,388,3096300,1536,713,823
470,21,388,3096400,1911,892,1019
471,21,388,3096500,1531,714,817
472,21,388,3096600,1201,564,637
473,21,388,3096700,2421,1145,1276
474,21,388,3096800,300,150,150
475,21,388,3096900,2933,1372,1561
476,21,388,3097000,945,501,444
477,21,388,3097100,1021,499,522
478,21,388,3097200,828,406,422
479,21,388,3097300,3206,1441,1765
480,21,388,3097400,2037,969,1068
481,21,388,3097500,731,355,376
482,21,388,3097600,1483,688,795
483,21,388,3097700,571,289,282
484,21,388,3097800,5283,2660,2623
485,21,388,3097900,0,0,0
486,21,388,3098000,1703,809,894
487,21,388,3098100,1611,733,878
488,21,388,3098200,3107,1454,1653
489,21,388,3098300,2419,1206,1213
490,21,388,3098400,1704,763,941
491,21,388,3098500,712,311,401
492,21,388,3098600,1950,939,1011
493,21,388,3098700,1334,665,669
494,21,388,3098800,0,0,0
495,21,388,3098900,0,0,0
496,21,388,3099000,282,133,149
497,21,388,3099100,1078,508,570
498,21,388,3099200,0,0,0
499,21,388,3099300,0,0,0
500,21,388,3099400,634,276,358
501,21,388,3099500,539,269,270
502,21,388,3099600,40,21,19
503,21,388,3099700,3182,1499,1683
504,21,388,3099800,82,32,50
505,21,388,3099900,0,0,0
506,21,388,3100000,45,21,24
507,21,388,3100100,0,0,0
508,21,388,3100200,0,0,0
509,21,388,3100300,0,0,0
510,21,388,3100400,0,0,0
511,21,388,3100500,209,108,101
512,21,388,3100600,62,33,29
513,21,388,3100700,0,0,0
514,21,388,3100800,31,13,18
515,21,388,3100900,3789,1857,1932
516,21,388,3101000,2514,1284,1230
517,21,388,3101100,542,273,269
518,21,388,3101200,1383,683,700
519,21,388,3101300,0,0,0
520,21,388,3101400,0,0,0
521,21,388,3101500,2258,1121,1137
522,21,388,3101600,155,81,74
523,21,388,3101700,439,221,218
524,21,388,3101800,44,22,22
525,21,388,3101900,253,98,155
526,21,388,3102000,1248,575,673
527,21,388,3102100,65,30,35
528,21,388,3102200,0,0,0
529,21,388,3102300,194,80,114
530,21,388,3102400,84,44,40
531,21,388,3102500,1400,696,704
532,21,388,3102600,34,15,19
533,21,388,3102700,127,60,67
534,21,388,3102800,214,118,96
535,21,388,3102900,242,108,134
536,21,388,3103000,465,215,250
537,21,388,3103100,853,407,446
538,21,388,3103200,118,50,68
539,21,388,3103300,61,32,29
540,21,388,3103400,266,144,122
541,21,388,3103500,79,34,45
542,21,388,3103600,0,0,0
543,21,388,3103700,178,83,95
544,21,388,3103800,35,20,15
545,21,388,3103900,663,307,356
546,21,388,3104000,889,400,489
547,21,388,3104100,159,83,76
548,21,388,3104200,3403,1725,1678
549,21,388,3104300,772,403,369
550,21,388,3104400,575,259,316
551,21,388,3104500,104,56,48
552,21,388,3104600,50,20,30
553,21,388,3104700,149,78,71
554,21,388,3104800,333,159,174
555,21,388,3104900,0,0,0
556,21,388,3105000,252,112,140
557,21,388,3105100,130,62,68
558,21,388,3105200,393,196,197
559,21,388,3105300,58,27,31
560,21,388,3105400,29,14,15
561,21,388,3105500,0,0,0
562,21,388,3105600,63,29,34
563,21,388,3105700,26,14,12
564,21,388,3105800,273,138,135
565,21,388,3105900,1633,879,754
566,21,388,3106000,0,0,0
567,21,388,3106100,352,181,171
568,21,388,3106200,253,135,118
569,21,388,3106300,0,0,0
570,21,388,3106400,321,163,158
571,21,388,3106500,585,303,282
572,21,388,3106600,1173,634,539
573,21,388,3106700,0,0,0
574,21,388,3106800,0,0,0
575,21,388,3106900,100,46,54
576,21,388,3107000,189,104,85
577,21,388,3107100,0,0,0
578,21,388,3107200,101,51,50
579,21,388,3107300,744,362,382
580,21,388,3107400,59,30,29
581,21,388,3107500,93,45,48
582,21,388,3107600,969,481,488
583,21,388,3107700,1100,563,537
584,21,388,3107800,581,291,290
585,21,388,3107900,413,195,218
586,21,388,3108000,192,88,104
587,21,388,3108100,5,2,3
588,21,388,3108200,173,90,83
589,21,388,3108300,772,378,394
590,21,388,3108400,271,152,119
591,21,388,3108500,1936,958,978
592,21,388,3108600,7,5,2
593,21,388,3108700,208,103,105
594,21,388,3108800,199,101,98
595,21,388,3108900,606,293,313
596,21,388,3109000,796,406,390
597,21,388,3109100,1346,645,701
598,21,388,3109200,315,152,163
599,21,388,3109300,614,288,326
600,21,388,3109400,1354,628,726
601,21,388,3109500,236,117,119
602,21,388,3109600,604,304,300
603,21,388,3109700,50,20,30
604,21,388,3109800,334,163,171
605,21,388,3109900,676,338,338
606,21,388,3110000,213,111,102
607,21,388,3110100,104,41,63
608,21,388,3110200,106,51,55
609,21,388,3110300,179,87,92
610,21,388,3110400,311,169,142
611,21,388,3110500,190,100,90
612,21,388,3110600,168,79,89
613,21,388,3110700,520,228,292
614,21,388,3110800,763,368,395
615,21,388,3110900,55,24,31
616,21,388,3111000,192,79,113
617,21,388,3111100,0,0,0
618,21,388,3111200,0,0,0
619,21,388,3111300,106,51,55
620,21,388,3111400,439,223,216
621,21,388,3111500,1116,617,499
622,21,388,3111600,425,215,210
623,21,388,3111700,432,213,219
624,21,388,3111800,898,476,422
625,21,388,3111900,1022,513,509
626,21,388,3112000,2333,1183,1150
627,21,388,3112100,395,193,202
628,21,388,3112200,204,104,100
629,21,388,3112300,1138,597,541
630,21,388,3112400,2233,1141,1092
631,21,388,3112500,273,137,136
632,21,388,3112600,444,224,220
633,21,388,3112700,447,212,235
634,21,388,3112800,3891,1853,2038
635,21,388,3112900,1603,746,857
636,21,388,3113000,2023,969,1054
637,21,388,3113100,1170,571,599
638,21,388,3113200,1585,803,782
639,21,388,3113300,491,264,227
640,21,388,3113400,684,338,346
641,21,388,3113500,3206,1604,1602
642,21,388,3113600,8,2,6
643,21,388,3113700,68,31,37
644,21,388,3113800,1263,618,645
645,21,388,3113900,66,32,34
646,21,388,3114000,228,116,112
647,21,388,3114100,2,1,1
648,21,388,3114200,63,30,33
649,21,388,3114300,89,48,41
650,21,388,3114400,355,186,169
651,21,388,3114500,0,0,0
652,21,388,3114600,1188,594,594
653,21,388,3114700,238,111,127
654,21,388,3114800,374,197,177
655,21,388,3114900,729,369,360
656,21,388,3115000,0,0,0
657,21,388,3115100,578,284,294
658,21,388,3115200,2233,1133,1100
659,21,388,3115300,590,283,307
660,21,388,3115400,2141,1099,1042
661,21,388,3115500,39,18,21
662,21,388,3115600,951,470,481
663,21,388,3115700,1381,743,638
664,21,388,3115800,2485,1174,1311
665,21,388,3115900,2031,993,1038
666,21,388,3116000,3497,1742,1755
667,21,388,3116100,0,0,0
668,21,388,3116200,39,17,22
669,21,388,3116300,0,0,0
670,21,388,3116400,37,20,17
671,21,388,3116500,16,8,8
672,21,388,3116600,72,39,33
673,21,388,3116700,5,2,3
674,21,388,3116800,238,121,117
675,21,388,3116900,30,14,16
676,21,388,3117000,71,30,41
677,21,388,3117100,200,102,98
678,21,388,3117200,102,51,51
679,21,388,3117300,49,29,20
680,21,388,3117400,0,0,0
681,21,388,3117500,0,0,0
682,21,388,3117600,94,56,38
683,21,388,3117700,198,85,113
684,21,388,3117800,0,0,0
685,21,388,3117900,72,36,36
686,21,388,3118000,0,0,0
687,21,388,3118100,29,11,18
688,21,388,3118200,60,25,35
689,21,388,3118300,175,87,88
690,21,388,3118400,55,22,33
691,21,388,3118500,122,62,60
692,21,388,3118600,40,18,22
693,21,388,3118700,65,34,31
694,21,388,3118800,139,73,66
695,21,388,3118900,53,27,26
696,21,388,3119000,16,11,5
697,21,388,3119100,1229,579,650
698,21,388,3119200,25,11,14
699,21,388,3119300,91,41,50
700,21,388,3119400,148,74,74
701,21,388,3119500,228,115,113
702,21,388,3119600,166,74,92
703,21,388,3119700,137,68,69
704,21,388,3119800,101,46,55
705,21,388,3119900,0,0,0
706,21,388,3120000,855,425,430
707,21,388,3120100,207,107,100
708,21,388,3120200,382,192,190
709,21,388,3120300,80,40,40
710,21,388,3120400,158,82,76
711,21,388,3120500,351,169,182
712,21,388,3120600,18,11,7
713,21,388,3120700,0,0,0
714,21,388,3120800,54,26,28
715,21,388,3120900,0,0,0
716,21,388,3121000,0,0,0
717,21,388,3121100,77,44,33
718,21,388,3121200,464,235,229
719,21,388,3121300,21,14,7
720,21,388,3121400,961,504,457
721,21,388,3121500,381,205,176
722,21,388,3121600,822,419,403
723,21,388,3121700,167,91,76
724,21,388,3121800,1332,672,660
725,21,388,3121900,224,109,115
726,21,388,3122000,2345,1180,1165
727,21,388,3122100,84,36,48
728,21,388,3122200,0,0,0
729,21,388,3122300,238,115,123
730,21,388,3122400,113,51,62
731,21,388,3122500,379,193,186
732,21,388,3122600,532,262,270
733,21,388,3122700,290,156,134
734,21,388,3122800,2096,1014,1082
735,21,388,3122900,1381,700,681
736,21,388,3123000,98,45,53
737,21,388,3123100,74,39,35
738,21,388,3123200,120,55,65
739,21,388,3123300,75,40,35
740,21,388,3123400,506,259,247
741,21,388,3123500,1094,537,557
742,21,388,3123600,829,420,409
743,21,388,3123700,953,496,457
744,21,388,3123800,343,177,166
745,21,388,3123900,1746,908,838
746,21,388,3124000,133,63,70
747,21,388,3124100,764,404,360
748,21,388,3124200,255,131,124
749,21,388,3124300,265,150,115
750,21,388,3124400,267,129,138
751,21,388,3124500,1595,835,760
752,21,388,3124600,41,17,24
753,21,388,3124700,590,276,314
754,21,388,3124800,894,458,436
755,21,388,3124900,0,0,0
756,21,388,3125000,0,0,0
757,21,388,3125100,0,0,0
758,21,388,3125200,202,98,104
759,21,388,3125300,85,46,39
760,21,388,3125400,170,96,74
761,21,388,3125500,533,247,286
762,21,388,3125600,34,18,16
763,21,388,3125700,0,0,0
764,21,388,3125800,107,50,57
765,21,388,3125900,151,75,76
766,21,388,3126000,167,77,90
767,21,388,3126100,397,196,201
768,21,388,3126200,589,313,276
769,21,388,3126300,476,233,243
770,21,388,3126400,0,0,0
771,21,388,3126500,0,0,0
772,21,388,3126600,0,0,0
773,21,388,3126700,588,295,293
774,21,388,3126800,1118,569,549
775,21,388,3126900,0,0,0
776,21,388,3127000,1716,904,812
777,21,388,3127100,941,479,462
778,21,388,3127200,2032,1024,1008
779,21,388,3127300,184,85,99
780,21,388,3127400,0,0,0
781,21,388,3127500,445,232,213
782,21,388,3127600,1234,627,607
783,21,388,3127700,1986,1054,932
784,21,388,3127800,46,21,25
785,21,388,3127900,3473,1774,1699
786,21,388,3128000,671,353,318
787,21,388,3128100,0,0,0
788,21,388,3128200,79,31,48
789,21,388,3128300,631,285,346
790,21,388,3128400,336,148,188
791,21,388,3128500,160,83,77
792,21,388,3128600,35,16,19
793,21,388,3128700,637,315,322
794,21,388,3128800,0,0,0
795,21,388,3128900,0,0,0
796,21,388,3129000,0,0,0
797,21,388,3129100,356,164,192
798,21,388,3129200,1273,624,649
799,21,388,3129300,452,212,240
800,21,388,3129400,1232,607,625
801,21,388,3129500,207,99,108
802,21,388,3129600,501,237,264
803,21,388,3129700,1474,731,743
804,21,388,3129800,694,334,360
805,21,388,3129900,2729,1422,1307
806,21,388,3130000,73,37,36
807,21,388,3130100,563,274,289
808,21,388,3130200,217,116,101
809,21,388,3130300,3432,1756,1676
810,21,388,3130400,764,384,380
811,21,388,3130500,0,0,0
812,21,388,3130600,130,63,67
813,21,388,3130700,43,22,21
814,21,388,3130800,7542,3835,3707
815,21,388,3130900,61,25,36
816,21,388,3131000,37,14,23
817,21,388,3131100,82,42,40
818,21,388,3131200,125,59,66
819,21,388,3131300,297,151,146
820,21,388,3131400,537,254,283
821,21,388,3131500,42,23,19
822,21,388,3131600,0,0,0
823,21,388,3131700,142,75,67
824,21,388,3131800,32,13,19
825,21,388,3131900,282,121,161
826,21,388,3132000,449,223,226
827,21,388,3132100,0,0,0
828,21,388,3132200,107,64,43
829,21,388,3132300,44,18,26
830,21,388,3132400,77,41,36
831,21,388,3132500,180,79,101
832,21,388,3132600,92,35,57
833,21,388,3132700,50,21,29
834,21,388,3132800,61,32,29
835,21,388,3132900,123,49,74
836,21,388,3133000,115,55,60
837,21,388,3133100,93,41,52
838,21,388,3133200,115,61,54
839,21,388,3133300,83,39,44
840,21,388,3133400,0,0,0
841,21,388,3133500,187,101,86
842,21,388,3133600,82,37,45
843,21,388,3133700,2281,1156,1125
844,21,388,3133800,447,206,241
845,21,388,3133900,238,109,129
846,21,388,3134000,159,75,84
847,21,388,3134100,130,69,61
848,21,388,3134200,192,93,99
849,21,388,3134300,96,51,45
850,21,388,3134400,142,72,70
851,21,388,3134500,60,32,28
852,21,388,3134600,202,94,108
853,21,388,3134700,280,131,149
854,21,388,3134800,127,64,63
855,21,388,3134900,299,166,133
856,21,388,3135000,149,72,77
857,21,388,3135100,342,166,176
858,21,388,3135200,1391,732,659
859,21,388,3135300,301,148,153
860,21,388,3135400,0,0,0
861,21,388,3135500,832,425,407
862,21,388,3135600,0,0,0
863,21,388,3135700,0,0,0
864,21,388,3135800,2378,1122,1256
865,21,388,3135900,72,36,36
866,21,388,3136000,578,293,285
867,21,388,3136100,2405,1222,1183
868,21,388,3136200,529,281,248
869,21,388,3136300,92,44,48
870,21,388,3136400,0,0,0
871,21,388,3136500,75,42,33
872,21,388,3136600,113,55,58
873,21,388,3136700,190,91,99
874,21,388,3136800,439,223,216
875,21,388,3136900,0,0,0
876,21,388,3137000,0,0,0
877,21,388,3137100,188,93,95
878,21,388,3137200,212,103,109
879,21,388,3137300,320,169,151
880,21,388,3137400,439,217,222
881,21,388,3137500,326,155,171
882,21,388,3137600,813,404,409
883,21,388,3137700,0,0,0
884,21,388,3137800,75,37,38
885,21,388,3137900,51,16,35
886,21,388,3138000,115,53,62
887,21,388,3138100,193,90,103
888,21,388,3138200,163,84,79
889,21,388,3138300,724,362,362
890,21,388,3138400,700,336,364
891,21,388,3138500,137,64,73
892,21,388,3138600,179,92,87
893,21,388,3138700,0,0,0
894,21,388,3138800,0,0,0
895,21,388,3138900,1281,646,635
896,21,388,3139000,722,366,356
897,21,388,3139100,1751,899,852
898,21,388,3139200,827,409,418
899,21,388,3139300,0,0,0
900,21,388,3139400,619,300,319
901,21,388,3139500,0,0,0
902,21,388,3139600,1236,625,611
903,21,388,3139700,830,423,407
904,21,388,3139800,297,149,148
905,21,388,3139900,544,292,252
906,21,388,3140000,3130,1631,1499
907,21,388,3140100,228,113,115
908,21,388,3140200,457,224,233
909,21,388,3140300,320,147,173
910,21,388,3140400,131,65,66
911,21,388,3140500,225,113,112
912,21,388,3140600,77,35,42
913,21,388,3140700,382,195,187
914,21,388,3140800,46,22,24
915,21,388,3140900,760,386,374
916,21,388,3141000,284,144,140
917,21,388,3141100,0,0,0
918,21,388,3141200,368,179,189
919,21,388,3141300,458,224,234
920,21,388,3141400,927,427,500
921,21,388,3141500,520,257,263
922,21,388,3141600,557,292,265
923,21,388,3141700,341,171,170
924,21,388,3141800,424,211,213
925,21,388,3141900,132,65,67
926,21,388,3142000,163,84,79
927,21,388,3142100,150,75,75
928,21,388,3142200,838,403,435
929,21,388,3142300,407,197,210
930,21,388,3142400,307,161,146
931,21,388,3142500,188,90,98
932,21,388,3142600,374,169,205
933,21,388,3142700,308,149,159
934,21,388,3142800,128,64,64
935,21,388,3142900,85,42,43
936,21,388,3143000,48,23,25
937,21,388,3143100,145,70,75
938,21,388,3143200,0,0,0
939,21,388,3143300,0,0,0
940,21,388,3143400,84,42,42
941,21,388,3143500,420,216,204
942,21,388,3143600,112,53,59
943,21,388,3143700,2619,1348,1271
944,21,388,3143800,1805,897,908
945,21,388,3143900,2400,1217,1183
946,21,388,3144000,1343,672,671
947,21,388,3144100,136,63,73
948,21,388,3144200,1764,952,812
949,21,388,3144300,917,481,436
950,21,388,3144400,2254,1180,1074
951,21,388,3144500,702,343,359
952,21,388,3144600,631,311,320
953,21,388,3144700,6194,3097,3097
954,21,388,3144800,2053,1008,1045
955,21,388,3144900,702,327,375
956,21,388,3145000,0,0,0
957,21,388,3145100,241,126,115
958,21,388,3145200,91,48,43
959,21,388,3145300,0,0,0
960,21,388,3145400,2198,1021,1177
961,21,388,3145500,3,2,1
962,21,388,3145600,113,48,65
963,21,388,3145700,468,243,225
964,21,388,3145800,442,226,216
965,21,388,3145900,1255,608,647
966,21,388,3146000,2905,1355,1550
967,21,388,3146100,25,8,17
968,21,388,3146200,2348,1103,1245
969,21,388,3146300,78,30,48
970,21,388,3146400,1019,489,530
971,21,388,3146500,4785,2343,2442
972,21,388,3146600,2182,1057,1125
973,21,388,3146700,1122,569,553
974,21,388,3146800,968,470,498
975,21,388,3146900,1052,503,549
976,21,388,3147000,789,384,405
977,21,388,3147100,1160,541,619
978,21,388,3147200,1281,661,620
979,21,388,3147300,1875,897,978
980,21,388,3147400,984,486,498
981,21,388,3147500,2494,1243,1251
982,21,388,3147600,815,430,385
983,21,388,3147700,65,30,35
984,21,388,3147800,451,204,247
985,21,388,3147900,350,160,190
986,21,388,3148000,2923,1434,1489
987,21,388,3148100,353,169,184
988,21,388,3148200,4058,1912,2146
989,21,388,3148300,722,367,355
990,21,388,3148400,209,100,109
991,21,388,3148500,653,330,323
992,21,388,3148600,1463,712,751
993,21,388,3148700,464,215,249
994,21,388,3148800,64,30,34
995,21,388,3148900,2487,1279,1208
996,21,388,3149000,0,0,0
997,21,388,3149100,1734,897,837
998,21,388,3149200,1347,686,661
999,21,388,3149300,577,279,298
1000,21,388,3149400,606,311,295
1001,21,388,3149500,0,0,0
1002,21,388,3149600,324,168,156
1003,21,388,3149700,444,224,220
1004,21,388,3149800,3768,1897,1871
1005,21,388,3149900,128,68,60
1006,21,388,3150000,144,77,67
1007,21,388,3150100,0,0,0
1008,21,388,3150200,109,46,63
1009,21,388,3150300,408,208,200
1010,21,388,3150400,4695,2360,2335
1011,21,388,3150500,266,142,124
1012,21,388,3150600,1244,618,626
1013,21,388,3150700,112,60,52
1014,21,388,3150800,454,227,227
1015,21,388,3150900,1826,947,879
1016,21,388,3151000,1250,573,677
1017,21,388,3151100,56,27,29
1018,21,388,3151200,420,213,207
1019,21,388,3151300,748,410,338
1020,21,388,3151400,3197,1541,1656
1021,21,388,3151500,626,310,316
1022,21,388,3151600,444,230,214
1023,21,388,3151700,4382,2250,2132
1024,21,388,3151800,1574,821,753
1025,21,388,3151900,1626,829,797
1026,21,388,3152000,1244,606,638
1027,21,388,3152100,700,320,380
1028,21,388,3152200,885,388,497
1029,21,388,3152300,4256,2198,2058
1030,21,388,3152400,1442,687,755
1031,21,388,3152500,834,374,460
1032,21,388,3152600,3413,1505,1908
1033,21,388,3152700,987,516,471
1034,21,388,3152800,723,363,360
1035,21,388,3152900,43,17,26
1036,21,388,3153000,751,382,369
1037,21,388,3153100,509,262,247
1038,21,388,3153200,2089,1040,1049
1039,21,388,3153300,0,0,0
1040,21,388,3153400,808,401,407
1041,21,388,3153500,870,433,437
1042,21,388,3153600,366,174,192
1043,21,388,3153700,1481,765,716
1044,21,388,3153800,561,292,269
1045,21,388,3153900,793,366,427
1046,21,388,3154000,1017,521,496
1047,21,388,3154100,6068,3042,3026
1048,21,388,3154200,2096,1049,1047
1049,21,388,3154300,1878,990,888
1050,21,388,3154400,3364,1707,1657
1051,21,388,3154500,789,375,414
1052,21,388,3154600,1279,637,642
1053,21,388,3154700,2748,1363,1385
1054,21,388,3154800,1631,840,791
1055,21,388,3154900,1071,550,521
1056,21,388,3155000,3070,1537,1533
1057,21,388,3155100,1627,808,819
1058,21,388,3155200,846,439,407
1059,21,388,3155300,0,0,0
1060,21,388,3155400,0,0,0
1061,21,388,3155500,1586,761,825
1062,21,388,3155600,843,416,427
1063,21,388,3155700,342,158,184
1064,21,388,3155800,0,0,0
1065,21,388,3155900,609,313,296
1066,21,388,3156000,1246,638,608
1067,21,388,3156100,1268,588,680
1068,21,388,3156200,11,6,5
1069,21,388,3156300,0,0,0
1070,21,388,3156400,112,53,59
1071,21,388,3156500,1378,682,696
1072,21,388,3156600,1334,697,637
1073,21,388,3156700,0,0,0
1074,21,388,3156800,2387,1231,1156
1075,21,388,3156900,2180,1113,1067
1076,21,388,3157000,1508,750,758
1077,21,388,3157100,340,179,161
1078,21,388,3157200,0,0,0
1079,21,388,3157300,2365,1233,1132
1080,21,388,3157400,698,378,320
1081,21,388,3157500,0,0,0
1082,21,388,3157600,701,341,360
1083,21,388,3157700,3327,1683,1644
1084,21,388,3157800,1621,809,812
1085,21,388,3157900,998,483,515
1086,21,388,3158000,729,351,378
1087,21,388,3158100,90,43,47
1088,21,388,3158200,1282,612,670
1089,21,388,3158300,1367,682,685
1090,21,388,3158400,1770,854,916
1091,21,388,3158500,2669,1252,1417
1092,21,388,3158600,1567,748,819
1093,21,388,3158700,0,0,0
1094,21,388,3158800,31,18,13
1095,21,388,3158900,0,0,0
1096,21,388,3159000,1658,822,836
1097,21,388,3159100,746,393,353
1098,21,388,3159200,0,0,0
1099,21,388,3159300,1474,753,721
1100,21,388,3159400,791,417,374
1101,21,388,3159500,2750,1316,1434
1102,21,388,3159600,309,163,146
1103,21,388,3159700,493,254,239
1104,21,388,3159800,206,98,108
1105,21,388,3159900,643,326,317
1106,21,388,3160000,56,29,27
1107,21,388,3160100,0,0,0
1108,21,388,3160200,0,0,0
1109,21,388,3160300,0,0,0
1110,21,388,3160400,840,399,441
1111,21,388,3160500,1526,700,826
1112,21,388,3160600,861,428,433
1113,21,388,3160700,1680,802,878
1114,21,388,3160800,497,215,282
1115,21,388,3160900,3319,1715,1604
1116,21,388,3161000,0,0,0
1117,21,388,3161100,585,305,280
1118,21,388,3161200,1809,950,859
1119,21,388,3161300,468,240,228
1120,21,388,3161400,98,48,50
1121,21,388,3161500,0,0,0
1122,21,388,3161600,1784,897,887
1123,21,388,3161700,1480,720,760
1124,21,388,3161800,569,290,279
1125,21,388,3161900,3334,1575,1759
1126,21,388,3162000,6304,3069,3235
1127,21,388,3162100,1129,568,561
1128,21,388,3162200,1974,937,1037
1129,21,388,3162300,1241,628,613
1130,21,388,3162400,0,0,0
1131,21,388,3162500,1301,649,652
1132,21,388,3162600,1453,719,734
1133,21,388,3162700,644,293,351
1134,21,388,3162800,227,112,115
1135,21,388,3162900,1642,832,810
1136,21,388,3163000,420,199,221
1137,21,388,3163100,169,89,80
1138,21,388,3163200,221,102,119
1139,21,388,3163300,523,247,276
1140,21,388,3163400,2592,1300,1292
1141,21,388,3163500,484,225,259
1142,21,388,3163600,674,341,333
1143,21,388,3163700,733,376,357
1144,21,388,3163800,455,224,231
1145,21,388,3163900,532,264,268
1146,21,388,3164000,1467,717,750
1147,21,388,3164100,83,34,49
1148,21,388,3164200,1052,483,569
1149,21,388,3164300,73,35,38
1150,21,388,3164400,873,409,464
1151,21,388,3164500,1401,742,659
1152,21,388,3164600,629,345,284
1153,21,388,3164700,427,217,210
1154,21,388,3164800,0,0,0
1155,21,388,3164900,540,283,257
1156,21,388,3165000,808,418,390
1157,21,388,3165100,1678,863,815
1158,21,388,3165200,1391,704,687
1159,21,388,3165300,92,42,50
1160,21,388,3165400,396,206,190
1161,21,388,3165500,1680,899,781
1162,21,388,3165600,0,0,0
1163,21,388,3165700,378,197,181
1164,21,388,3165800,323,169,154
1165,21,388,3165900,749,382,367
1166,21,388,3166000,320,152,168
1167,21,388,3166100,270,136,134
1168,21,388,3166200,1515,762,753
1169,21,388,3166300,1107,543,564
1170,21,388,3166400,545,250,295
1171,21,388,3166500,0,0,0
1172,21,388,3166600,2813,1351,1462
1173,21,388,3166700,1463,733,730
1174,21,388,3166800,1795,897,898
1175,21,388,3166900,2063,1041,1022
1176,21,388,3167000,1381,668,713
1177,21,388,3167100,1769,872,897
1178,21,388,3167200,2480,1220,1260
1179,21,388,3167300,2890,1459,1431
1180,21,388,3167400,1249,575,674
1181,21,388,3167500,3629,1767,1862
1182,21,388,3167600,366,181,185
1183,21,388,3167700,276,147,129
1184,21,388,3167800,3768,1850,1918
1185,21,388,3167900,2801,1386,1415
1186,21,388,3168000,1305,635,670
1187,21,388,3168100,3636,1790,1846
1188,21,388,3168200,3784,1864,1920
1189,21,388,3168300,567,281,286
1190,21,388,3168400,4365,2281,2084
1191,21,388,3168500,790,370,420
1192,21,388,3168600,1325,643,682
1193,21,388,3168700,4,2,2
1194,21,388,3168800,972,455,517
1195,21,388,3168900,761,384,377
1196,21,388,3169000,608,300,308
1197,21,388,3169100,2000,990,1010
1198,21,388,3169200,1234,643,591
1199,21,388,3169300,1425,695,730
1200,21,388,3169400,974,456,518
1201,21,388,3169500,765,394,371
1202,21,388,3169600,3240,1610,1630
1203,21,388,3169700,0,0,0
1204,21,388,3169800,1977,980,997
1205,21,388,3169900,1809,905,904
1206,21,388,3170000,1510,726,784
1207,21,388,3170100,1728,825,903
1208,21,388,3170200,2591,1273,1318
1209,21,388,3170300,1171,589,582
1210,21,388,3170400,480,216,264
1211,21,388,3170500,838,378,460
1212,21,388,3170600,343,146,197
1213,21,388,3170700,2262,1173,1089
1214,21,388,3170800,981,454,527
1215,21,388,3170900,7704,3840,3864
1216,21,388,3171000,2381,1221,1160
1217,21,388,3171100,3447,1710,1737
1218,21,388,3171200,4697,2283,2414
1219,21,388,3171300,1587,707,880
1220,21,388,3171400,592,283,309
1221,21,388,3171500,3903,1909,1994
1222,21,388,3171600,520,233,287
1223,21,388,3171700,0,0,0
1224,21,388,3171800,0,0,0
1225,21,388,3171900,1017,472,545
1226,21,388,3172000,2418,1146,1272
1227,21,388,3172100,1080,548,532
1228,21,388,3172200,494,250,244
1229,21,388,3172300,2954,1505,1449
1230,21,388,3172400,554,282,272
1231,21,388,3172500,13,5,8
1232,21,388,3172600,1388,700,688
1233,21,388,3172700,10,4,6
1234,21,388,3172800,2345,1214,1131
1235,21,388,3172900,975,461,514
1236,21,388,3173000,0,0,0
1237,21,388,3173100,33,18,15
1238,21,388,3173200,1567,727,840
1239,21,388,3173300,754,379,375
1240,21,388,3173400,1560,778,782
1241,21,388,3173500,2295,1057,1238
1242,21,388,3173600,1900,980,920
1243,21,388,3173700,1862,891,971
1244,21,388,3173800,2759,1336,1423
1245,21,388,3173900,1342,681,661
1246,21,388,3174000,1483,764,719
1247,21,388,3174100,836,427,409
1248,21,388,3174200,844,427,417
1249,21,388,3174300,2368,1122,1246
1250,21,388,3174400,1175,620,555
1251,21,388,3174500,581,280,301
1252,21,388,3174600,865,435,430
1253,21,388,3174700,6087,2858,3229
1254,21,388,3174800,1109,540,569
1255,21,388,3174900,1100,487,613
1256,21,388,3175000,3029,1497,1532
1257,21,388,3175100,2374,1107,1267
1258,21,388,3175200,1011,501,510
1259,21,388,3175300,1223,605,618
1260,21,388,3175400,0,0,0
1261,21,388,3175500,1084,489,595
1262,21,388,3175600,1437,679,758
1263,21,388,3175700,0,0,0
1264,21,388,3175800,0,0,0
1265,21,388,3175900,0,0,0
1266,21,388,3176000,512,269,243
1267,21,388,3176100,299,146,153
1268,21,388,3176200,43,16,27
1269,21,388,3176300,251,125,126
1270,21,388,3176400,0,0,0
1271,21,388,3176500,1957,1019,938
1272,21,388,3176600,1842,901,941
1273,21,388,3176700,1,1,0
1274,21,388,3176800,6403,3014,3389
1275,21,388,3176900,1308,616,692
1276,21,388,3177000,1802,832,970
1277,21,388,3177100,1043,513,530
1278,21,388,3177200,2129,990,1139
1279,21,388,3177300,1023,541,482
1280,21,388,3177400,1287,659,628
1281,21,388,3177500,2291,1188,1103
1282,21,388,3177600,2242,1089,1153
1283,21,388,3177700,449,224,225
1284,21,388,3177800,1507,801,706
1285,21,388,3177900,6404,3249,3155
1286,21,388,3178000,281,136,145
1287,21,388,3178100,358,188,170
1288,21,388,3178200,1067,570,497
1289,21,388,3178300,2098,1022,1076
1290,21,388,3178400,1170,589,581
1291,21,388,3178500,810,427,383
1292,21,388,3178600,1787,904,883
1293,21,388,3178700,1396,710,686
1294,21,388,3178800,1499,736,763
1295,21,388,3178900,1500,763,737
1296,21,388,3179000,892,467,425
1297,21,388,3179100,1364,624,740
1298,21,388,3179200,1672,790,882
1299,21,388,3179300,1443,700,743
1300,21,388,3179400,2776,1441,1335
1301,21,388,3179500,1236,599,637
1302,21,388,3179600,2734,1299,1435
1303,21,388,3179700,1760,869,891
1304,21,388,3179800,663,299,364
1305,21,388,3179900,436,208,228
1306,21,388,3180000,2693,1314,1379
1307,21,388,3180100,907,427,480
1308,21,388,3180200,2291,1209,1082
1309,21,388,3180300,233,115,118
1310,21,388,3180400,5366,2638,2728
1311,21,388,3180500,1179,616,563
1312,21,388,3180600,1442,709,733
1313,21,388,3180700,702,353,349
1314,21,388,3180800,2434,1236,1198
1315,21,388,3180900,0,0,0
1316,21,388,3181000,0,0,0
1317,21,388,3181100,0,0,0
1318,21,388,3181200,0,0,0
1319,21,388,3181300,0,0,0
1320,21,388,3181400,1864,873,991
1321,21,388,3181500,470,214,256
1322,21,388,3181600,2438,1113,1325
1323,21,388,3181700,1372,678,694
1324,21,388,3181800,702,338,364
1325,21,388,3181900,330,168,162
1326,21,388,3182000,6157,3134,3023
1327,21,388,3182100,800,389,411
1328,21,388,3182200,1278,619,659
1329,21,388,3182300,1771,867,904
1330,21,388,3182400,688,333,355
1331,21,388,3182500,2009,990,1019
1332,21,388,3182600,2967,1529,1438
1333,21,388,3182700,869,408,461
1334,21,388,3182800,1017,499,518
1335,21,388,3182900,1294,580,714
1336,21,388,3183000,568,298,270
1337,21,388,3183100,749,322,427
1338,21,388,3183200,1057,499,558
1339,21,388,3183300,499,231,268
1340,21,388,3183400,966,477,489
1341,21,388,3183500,2971,1451,1520
1342,21,388,3183600,2709,1352,1357
1343,21,388,3183700,2721,1327,1394
1344,21,388,3183800,1162,575,587
1345,21,388,3183900,740,359,381
1346,21,388,3184000,889,425,464
1347,21,388,3184100,2459,1150,1309
1348,21,388,3184200,1156,547,609
1349,21,388,3184300,1811,921,890
1350,21,388,3184400,1952,971,981
1351,21,388,3184500,367,202,165
1352,21,388,3184600,2120,1029,1091
1353,21,388,3184700,1950,1014,936
1354,21,388,3184800,701,366,335
1355,21,388,3184900,907,439,468
1356,21,388,3185000,720,352,368
1357,21,388,3185100,2617,1287,1330
1358,21,388,3185200,542,270,272
1359,21,388,3185300,655,330,325
1360,21,388,3185400,0,0,0
1361,21,388,3185500,1047,527,520
1362,21,388,3185600,6461,3144,3317
1363,21,388,3185700,2798,1353,1445
1364,21,388,3185800,131,62,69
1365,21,388,3185900,137,72,65
1366,21,388,3186000,186,92,94
1367,21,388,3186100,23,13,10
1368,21,388,3186200,243,115,128
1369,21,388,3186300,113,65,48
1370,21,388,3186400,272,137,135
1371,21,388,3186500,432,230,202
1372,21,388,3186600,734,386,348
1373,21,388,3186700,186,97,89
1374,21,388,3186800,59,27,32
1375,21,388,3186900,8,4,4
1376,21,388,3187000,876,443,433
1377,21,388,3187100,106,52,54
1378,21,388,3187200,2262,1150,1112
1379,21,388,3187300,1077,503,574
1380,21,388,3187400,92,43,49
1381,21,388,3187500,189,90,99
1382,21,388,3187600,89,44,45
1383,21,388,3187700,1215,586,629
1384,21,388,3187800,97,48,49
1385,21,388,3187900,0,0,0
1386,21,388,3188000,205,98,107
1387,21,388,3188100,137,72,65
1388,21,388,3188200,125,68,57
1389,21,388,3188300,242,137,105
1390,21,388,3188400,18,10,8
1391,21,388,3188500,44,22,22
1392,21,388,3188600,32,12,20
1393,21,388,3188700,366,187,179
1394,21,388,3188800,88,44,44
1395,21,388,3188900,96,54,42
1396,21,388,3189000,100,53,47
1397,21,388,3189100,58,33,25
1398,21,388,3189200,109,49,60
1399,21,388,3189300,1113,569,544
1400,21,388,3189400,1261,625,636
1401,21,388,3189500,0,0,0
1402,21,388,3189600,110,53,57
1403,21,388,3189700,0,0,0
1404,21,388,3189800,0,0,0
1405,21,388,3189900,3076,1535,1541
1406,21,388,3190000,0,0,0
1407,21,388,3190100,33,17,16
1408,21,388,3190200,21,10,11
1409,21,388,3190300,752,366,386
1410,21,388,3190400,0,0,0
1411,21,388,3190500,407,192,215
1412,21,388,3190600,58,29,29
1413,21,388,3190700,139,77,62
1414,21,388,3190800,1694,813,881
1415,21,388,3190900,1767,844,923
1416,21,388,3191000,727,321,406
1417,21,388,3191100,2053,959,1094
1418,21,388,3191200,189,101,88
1419,21,388,3191300,26,12,14
1420,21,388,3191400,590,275,315
1421,21,388,3191500,168,81,87
1422,21,388,3191600,26,10,16
1423,21,388,3191700,113,54,59
1424,21,388,3191800,130,68,62
1425,21,388,3191900,120,55,65
1426,21,388,3192000,56,33,23
1427,21,388,3192100,7,4,3
1428,21,388,3192200,0,0,0
1429,21,388,3192300,0,0,0
1430,21,388,3192400,209,108,101
1431,21,388,3192500,63,30,33
1432,21,388,3192600,149,78,71
1433,21,388,3192700,194,93,101
1434,21,388,3192800,137,66,71
1435,21,388,3192900,152,78,74
1436,21,388,3193000,62,39,23
1437,21,388,3193100,0,0,0
1438,21,388,3193200,43,13,30
1439,21,388,3193300,29,15,14
1440,21,388,3193400,33,20,13
1441,21,388,3193500,60,27,33
1442,21,388,3193600,99,49,50
1443,21,388,3193700,68,34,34
1444,21,388,3193800,923,458,465
1445,21,388,3193900,2807,1332,1475
1446,21,388,3194000,380,186,194
1447,21,388,3194100,3013,1433,1580
1448,21,388,3194200,3797,1886,1911
1449,21,388,3194300,1048,520,528
1450,21,388,3194400,2484,1243,1241
1451,21,388,3194500,740,361,379
1452,21,388,3194600,1304,637,667
1453,21,388,3194700,1554,723,831
1454,21,388,3194800,580,267,313
1455,21,388,3194900,2087,1009,1078
1456,21,388,3195000,144,70,74
1457,21,388,3195100,59,30,29
1458,21,388,3195200,4,1,3
1459,21,388,3195300,0,0,0
1460,21,388,3195400,824,377,447
1461,21,388,3195500,0,0,0
1462,21,388,3195600,0,0,0
1463,21,388,3195700,0,0,0
1464,21,388,3195800,49,22,27
1465,21,388,3195900,543,289,254
1466,21,388,3196000,337,184,153
1467,21,388,3196100,535,282,253
1468,21,388,3196200,37,18,19
1469,21,388,3196300,691,339,352
1470,21,388,3196400,2712,1329,1383
1471,21,388,3196500,1056,521,535
1472,21,388,3196600,99,45,54
1473,21,388,3196700,187,106,81
1474,21,388,3196800,0,0,0
1475,21,388,3196900,266,122,144
1476,21,388,3197000,0,0,0
1477,21,388,3197100,1017,521,496
1478,21,388,3197200,2436,1221,1215
1479,21,388,3197300,0,0,0
1480,21,388,3197400,372,177,195
1481,21,388,3197500,1164,563,601
1482,21,388,3197600,0,0,0
1483,21,388,3197700,1878,909,969
1484,21,388,3197800,1840,893,947
1485,21,388,3197900,461,255,206
1486,21,388,3198000,309,155,154
1487,21,388,3198100,0,0,0
1488,21,388,3198200,0,0,0
1489,21,388,3198300,454,225,229
1490,21,388,3198400,0,0,0
1491,21,388,3198500,2089,1010,1079
1492,21,388,3198600,2199,1098,1101
1493,21,388,3198700,583,293,290
1494,21,388,3198800,1068,484,584
1495,21,388,3198900,786,369,417
1496,21,388,3199000,577,300,277
1497,21,388,3199100,282,147,135
1498,21,388,3199200,1195,556,639
1499,21,388,3199300,0,0,0
1500,21,388,3199400,0,0,0
1501,21,388,3199500,0,0,0
1502,21,388,3199600,0,0,0
1503,21,388,3199700,334,169,165
1504,21,388,3199800,133,65,68
1505,21,388,3199900,25,14,11
1506,21,388,3200000,50,25,25
1507,21,388,3200100,145,70,75
1508,21,388,3200200,982,510,472
1509,21,388,3200300,1981,980,1001
1510,21,388,3200400,2217,1042,1175
1511,21,388,3200500,578,282,296
1512,21,388,3200600,609,300,309
1513,21,388,3200700,1103,573,530
1514,21,388,3200800,2773,1426,1347
1515,21,388,3200900,1690,794,896
1516,21,388,3201000,207,96,111
1517,21,388,3201100,0,0,0
1518,21,388,3201200,4316,2269,2047
1519,21,388,3201300,1140,553,587
1520,21,388,3201400,397,206,191
1521,21,388,3201500,3646,1893,1753
1522,21,388,3201600,1913,991,922
1523,21,388,3201700,2434,1259,1175
1524,21,388,3201800,1922,966,956
1525,21,388,3201900,1691,816,875
1526,21,388,3202000,253,120,133
1527,21,388,3202100,122,62,60
1528,21,388,3202200,18,10,8
1529,21,388,3202300,0,0,0
1530,21,388,3202400,0,0,0
1531,21,388,3202500,0,0,0
1532,21,388,3202600,53,29,24
1533,21,388,3202700,2871,1329,1542
1534,21,388,3202800,27,15,12
1535,21,388,3202900,637,318,319
1536,21,388,3203000,1234,579,655
1537,21,388,3203100,0,0,0
1538,21,388,3203200,0,0,0
1539,21,388,3203300,0,0,0
1540,21,388,3203400,0,0,0
1541,21,388,3203500,0,0,0
1542,21,388,3203600,0,0,0
1543,21,388,3203700,0,0,0
1544,21,388,3203800,0,0,0
1545,21,388,3203900,933,482,451
1546,21,388,3204000,1699,854,845
1547,21,388,3204100,968,500,468
1548,21,388,3204200,413,198,215
1549,21,388,3204300,294,154,140
1550,21,388,3204400,1912,922,990
1551,21,388,3204500,0,0,0
1552,21,388,3204600,109,48,61
1553,21,388,3204700,0,0,0
1554,21,388,3204800,0,0,0
1555,21,388,3204900,0,0,0
1556,21,388,3205000,177,89,88
1557,21,388,3205100,164,77,87
1558,21,388,3205200,79,39,40
1559,21,388,3205300,44,26,18
1560,21,388,3205400,339,180,159
1561,21,388,3205500,157,79,78
1562,21,388,3205600,0,0,0
1563,21,388,3205700,7765,3730,4035
1564,21,388,3205800,1144,562,582
1565,21,388,3205900,623,291,332
1566,21,388,3206000,1161,561,600
1567,21,388,3206100,0,0,0
1568,21,388,3206200,1938,987,951
1569,21,388,3206300,0,0,0
1570,21,388,3206400,493,253,240
1571,21,388,3206500,733,339,394
1572,21,388,3206600,0,0,0
1573,21,388,3206700,1755,903,852
1574,21,388,3206800,3380,1767,1613
1575,21,388,3206900,0,0,0
1576,21,388,3207000,1229,684,545
1577,21,388,3207100,3360,1565,1795
1578,21,388,3207200,0,0,0
1579,21,388,3207300,1224,560,664
1580,21,388,3207400,743,359,384
1581,21,388,3207500,2053,1039,1014
1582,21,388,3207600,89,44,45
1583,21,388,3207700,828,435,393
1584,21,388,3207800,1707,818,889
1585,21,388,3207900,714,320,394
1586,21,388,3208000,876,425,451
1587,21,388,3208100,2286,1137,1149
1588,21,388,3208200,0,0,0
1589,21,388,3208300,1795,860,935
1590,21,388,3208400,1620,782,838
1591,21,388,3208500,1177,567,610
1592,21,388,3208600,495,252,243
1593,21,388,3208700,466,234,232
1594,21,388,3208800,231,113,118
1595,21,388,3208900,1096,471,625
1596,21,388,3209000,2121,969,1152
1597,21,388,3209100,299,151,148
1598,21,388,3209200,25,13,12
1599,21,388,3209300,731,372,359
1600,21,388,3209400,634,334,300
1601,21,388,3209500,66,31,35
1602,21,388,3209600,1613,801,812
1603,21,388,3209700,2990,1507,1483
1604,21,388,3209800,0,0,0
1605,21,388,3209900,0,0,0
1606,21,388,3210000,1538,764,774
1607,21,388,3210100,1440,751,689
1608,21,388,3210200,1527,724,803
1609,21,388,3210300,1396,672,724
1610,21,388,3210400,1536,776,760
1611,21,388,3210500,1837,847,990
1612,21,388,3210600,355,167,188
1613,21,388,3210700,635,336,299
1614,21,388,3210800,767,361,406
1615,21,388,3210900,1090,482,608
1616,21,388,3211000,658,286,372
1617,21,388,3211100,0,0,0
1618,21,388,3211200,580,272,308
1619,21,388,3211300,4568,2151,2417
1620,21,388,3211400,2559,1228,1331
1621,21,388,3211500,502,215,287
1622,21,388,3211600,1768,873,895
1623,21,388,3211700,147,74,73
1624,21,388,3211800,1077,504,573
1625,21,388,3211900,612,314,298
1626,21,388,3212000,0,0,0
1627,21,388,3212100,1193,582,611
1628,21,388,3212200,0,0,0
1629,21,388,3212300,1171,588,583
1630,21,388,3212400,874,434,440
1631,21,388,3212500,82,43,39
1632,21,388,3212600,485,227,258
1633,21,388,3212700,0,0,0
1634,21,388,3212800,549,275,274
1635,21,388,3212900,24,14,10
1636,21,388,3213000,240,119,121
1637,21,388,3213100,361,161,200
1638,21,388,3213200,186,82,104
1639,21,388,3213300,234,112,122
1640,21,388,3213400,111,52,59
1641,21,388,3213500,0,0,0
1642,21,388,3213600,427,215,212
1643,21,388,3213700,674,329,345
1644,21,388,3213800,244,130,114
1645,21,388,3213900,338,184,154
1646,21,388,3214000,216,102,114
1647,21,388,3214100,82,35,47
1648,21,388,3214200,227,113,114
1649,21,388,3214300,3998,2024,1974
1650,21,388,3214400,328,164,164
1651,21,388,3214500,64,32,32
1652,21,388,3214600,336,184,152
1653,21,388,3214700,0,0,0
1654,21,388,3214800,0,0,0
1655,21,388,3214900,0,0,0
1656,21,388,3215000,82,40,42
1657,21,388,3215100,252,122,130
1658,21,388,3215200,0,0,0
1659,21,388,3215300,0,0,0
1660,21,388,3215400,0,0,0
1661,21,388,3215500,99,50,49
1662,21,388,3215600,0,0,0
1663,21,388,3215700,763,381,382
1664,21,388,3215800,927,473,454
1665,21,388,3215900,1106,544,562
1666,21,388,3216000,403,190,213
1667,21,388,3216100,0,0,0
1668,21,388,3216200,0,0,0
1669,21,388,3216300,0,0,0
1670,21,388,3216400,0,0,0
1671,21,388,3216500,0,0,0
1672,21,388,3216600,294,139,155
1673,21,388,3216700,2981,1460,1521
1674,21,388,3216800,0,0,0
1675,21,388,3216900,3212,1496,1716
1676,21,388,3217000,2182,1046,1136
1677,21,388,3217100,1311,620,691
1678,21,388,3217200,810,434,376
1679,21,388,3217300,936,448,488
1680,21,388,3217400,17,11,6
1681,21,388,3217500,1541,743,798
1682,21,388,3217600,414,199,215
1683,21,388,3217700,121,48,73
1684,21,388,3217800,0,0,0
1685,21,388,3217900,1605,789,816
1686,21,388,3218000,175,82,93
1687,21,388,3218100,994,494,500
1688,21,388,3218200,1592,779,813
1689,21,388,3218300,0,0,0
1690,21,388,3218400,0,0,0
1691,21,388,3218500,0,0,0
1692,21,388,3218600,355,174,181
1693,21,388,3218700,88,46,42
1694,21,388,3218800,1905,969,936
1695,21,388,3218900,1534,767,767
1696,21,388,3219000,420,198,222
1697,21,388,3219100,235,103,132
1698,21,388,3219200,493,228,265
1699,21,388,3219300,1354,647,707
1700,21,388,3219400,289,130,159
1701,21,388,3219500,0,0,0
1702,21,388,3219600,4411,2168,2243
1703,21,388,3219700,1881,902,979
1704,21,388,3219800,966,468,498
1705,21,388,3219900,1224,605,619
1706,21,388,3220000,578,260,318
1707,21,388,3220100,0,0,0
1708,21,388,3220200,0,0,0
1709,21,388,3220300,168,80,88
1710,21,388,3220400,869,403,466
1711,21,388,3220500,968,502,466
1712,21,388,3220600,0,0,0
1713,21,388,3220700,0,0,0
1714,21,388,3220800,77,44,33
1715,21,388,3220900,1395,714,681
1716,21,388,3221000,356,181,175
1717,21,388,3221100,0,0,0
1718,21,388,3221200,0,0,0
1719,21,388,3221300,0,0,0
1720,21,388,3221400,147,63,84
1721,21,388,3221500,0,0,0
1722,21,388,3221600,361,203,158
1723,21,388,3221700,549,260,289
1724,21,388,3221800,879,427,452
1725,21,388,3221900,608,323,285
1726,21,388,3222000,1037,541,496
1727,21,388,3222100,690,351,339
1728,21,388,3222200,123,66,57
1729,21,388,3222300,234,126,108
1730,21,388,3222400,103,53,50
1731,21,388,3222500,3851,1955,1896
1732,21,388,3222600,107,62,45
1733,21,388,3222700,581,269,312
1734,21,388,3222800,257,131,126
1735,21,388,3222900,1039,505,534
1736,21,388,3223000,979,508,471
1737,21,388,3223100,321,167,154
1738,21,388,3223200,2320,1209,1111
1739,21,388,3223300,1340,695,645
1740,21,388,3223400,1174,599,575
1741,21,388,3223500,1042,559,483
1742,21,388,3223600,702,352,350
1743,21,388,3223700,20,15,5
1744,21,388,3223800,5800,2957,2843
1745,21,388,3223900,1403,704,699
1746,21,388,3224000,773,408,365
1747,21,388,3224100,0,0,0
1748,21,388,3224200,626,318,308
1749,21,388,3224300,0,0,0
1750,21,388,3224400,5737,2913,2824
1751,21,388,3224500,0,0,0
1752,21,388,3224600,31,13,18
1753,21,388,3224700,338,157,181
1754,21,388,3224800,98,44,54
1755,21,388,3224900,0,0,0
1756,21,388,3225000,32,10,22
1757,21,388,3225100,0,0,0
1758,21,388,3225200,0,0,0
1759,21,388,3225300,0,0,0
1760,21,388,3225400,206,109,97
1761,21,388,3225500,528,276,252
1762,21,388,3225600,1335,683,652
1763,21,388,3225700,616,299,317
1764,21,388,3225800,1161,540,621
1765,21,388,3225900,2832,1368,1464
1766,21,388,3226000,147,64,83
1767,21,388,3226100,6,4,2
1768,21,388,3226200,1619,812,807
1769,21,388,3226300,2325,1208,1117
1770,21,388,3226400,1277,577,700
1771,21,388,3226500,1598,815,783
1772,21,388,3226600,0,0,0
1773,21,388,3226700,1748,827,921
1774,21,388,3226800,1418,691,727
1775,21,388,3226900,338,164,174
1776,21,388,3227000,0,0,0
1777,21,388,3227100,2463,1189,1274
1778,21,388,3227200,1636,810,826
1779,21,388,3227300,2617,1394,1223
1780,21,388,3227400,2456,1222,1234
1781,21,388,3227500,743,394,349
1782,21,388,3227600,294,149,145
1783,21,388,3227700,0,0,0
1784,21,388,3227800,166,80,86
1785,21,388,3227900,0,0,0
1786,21,388,3228000,675,342,333
1787,21,388,3228100,0,0,0
1788,21,388,3228200,170,88,82
1789,21,388,3228300,54,27,27
1790,21,388,3228400,0,0,0
1791,21,388,3228500,0,0,0
1792,21,388,3228600,0,0,0
1793,21,388,3228700,586,278,308
1794,21,388,3228800,236,111,125
1795,21,388,3228900,874,408,466
1796,21,388,3229000,0,0,0
1797,21,388,3229100,184,94,90
1798,21,388,3229200,0,0,0
1799,21,388,3229300,874,447,427
1800,21,388,3229400,0,0,0
1801,21,388,3229500,859,444,415
1802,21,388,3229600,54,21,33
1803,21,388,3229700,112,55,57
1804,21,388,3229800,0,0,0
1805,21,388,3229900,1430,733,697
1806,21,388,3230000,75,37,38
1807,21,388,3230100,1493,742,751
1808,21,388,3230200,246,119,127
1809,21,388,3230300,207,102,105
1810,21,388,3230400,24,13,11
1811,21,388,3230500,0,0,0
1812,21,388,3230600,0,0,0
1813,21,388,3230700,721,351,370
1814,21,388,3230800,0,0,0
1815,21,388,3230900,0,0,0
1816,21,388,3231000,429,213,216
1817,21,388,3231100,676,315,361
1818,21,388,3231200,221,104,117
1819,21,388,3231300,0,0,0
1820,21,388,3231400,303,163,140
1821,21,388,3231500,165,80,85
1822,21,388,3231600,541,256,285
1823,21,388,3231700,834,407,427
1824,21,388,3231800,6624,3368,3256
1825,21,388,3231900,219,85,134
1826,21,388,3232000,1598,818,780
1827,21,388,3232100,252,122,130
1828,21,388,3232200,305,150,155
1829,21,388,3232300,0,0,0
1830,21,388,3232400,617,308,309
1831,21,388,3232500,0,0,0
1832,21,388,3232600,145,69,76
1833,21,388,3232700,401,199,202
1834,21,388,3232800,14,5,9
1835,21,388,3232900,606,309,297
1836,21,388,3233000,723,376,347
1837,21,388,3233100,465,234,231
1838,21,388,3233200,1482,691,791
1839,21,388,3233300,0,0,0
1840,21,388,3233400,2836,1407,1429
1841,21,388,3233500,1150,581,569
1842,21,388,3233600,601,311,290
1843,21,388,3233700,1210,635,575
1844,21,388,3233800,745,382,363
1845,21,388,3233900,0,0,0
1846,21,388,3234000,352,188,164
1847,21,388,3234100,808,439,369
1848,21,388,3234200,0,0,0
1849,21,388,3234300,821,401,420
1850,21,388,3234400,0,0,0
1851,21,388,3234500,297,155,142
1852,21,388,3234600,0,0,0
1853,21,388,3234700,0,0,0
1854,21,388,3234800,0,0,0
1855,21,388,3234900,0,0,0
1856,21,388,3235000,0,0,0
1857,21,388,3235100,2569,1307,1262
1858,21,388,3235200,0,0,0
1859,21,388,3235300,1381,702,679
1860,21,388,3235400,300,151,149
1861,21,388,3235500,516,262,254
1862,21,388,3235600,0,0,0
1863,21,388,3235700,0,0,0
1864,21,388,3235800,0,0,0
1865,21,388,3235900,1210,596,614
1866,21,388,3236000,217,116,101
1867,21,388,3236100,2269,1109,1160
1868,21,388,3236200,203,101,102
1869,21,388,3236300,734,395,339
1870,21,388,3236400,1328,665,663
1871,21,388,3236500,259,118,141
1872,21,388,3236600,701,337,364
1873,21,388,3236700,509,262,247
1874,21,388,3236800,475,250,225
1875,21,388,3236900,2305,1177,1128
1876,21,388,3237000,1311,677,634
1877,21,388,3237100,989,480,509
1878,21,388,3237200,1040,520,520
1879,21,388,3237300,314,157,157
1880,21,388,3237400,98,44,54
1881,21,388,3237500,524,271,253
1882,21,388,3237600,417,197,220
1883,21,388,3237700,1242,647,595
1884,21,388,3237800,1280,648,632
1885,21,388,3237900,0,0,0
1886,21,388,3238000,0,0,0
1887,21,388,3238100,568,311,257
1888,21,388,3238200,255,136,119
1889,21,388,3238300,0,0,0
1890,21,388,3238400,346,178,168
1891,21,388,3238500,711,379,332
1892,21,388,3238600,254,133,121
1893,21,388,3238700,462,227,235
1894,21,388,3238800,0,0,0
1895,21,388,3238900,1354,702,652
1896,21,388,3239000,0,0,0
1897,21,388,3239100,921,503,418
1898,21,388,3239200,406,187,219
1899,21,388,3239300,964,512,452
1900,21,388,3239400,415,207,208
1901,21,388,3239500,0,0,0
1902,21,388,3239600,0,0,0
1903,21,388,3239700,136,72,64
1904,21,388,3239800,1682,848,834
1905,21,388,3239900,80,35,45
1906,21,388,3240000,4802,2454,2348
1907,21,388,3240100,320,151,169
1908,21,388,3240200,278,156,122
1909,21,388,3240300,379,193,186
1910,21,388,3240400,1460,780,680
1911,21,388,3240500,279,149,130
1912,21,388,3240600,655,333,322
1913,21,388,3240700,1190,620,570
1914,21,388,3240800,368,171,197
1915,21,388,3240900,1492,844,648
1916,21,388,3241000,885,472,413
1917,21,388,3241100,5682,2928,2754
1918,21,388,3241200,1782,898,884
1919,21,388,3241300,0,0,0
1920,21,388,3241400,837,430,407
1921,21,388,3241500,422,192,230
1922,21,388,3241600,0,0,0
1923,21,388,3241700,773,388,385
1924,21,388,3241800,0,0,0
1925,21,388,3241900,1165,567,598
1926,21,388,3242000,1774,934,840
1927,21,388,3242100,2743,1395,1348
1928,21,388,3242200,0,0,0
1929,21,388,3242300,586,278,308
1930,21,388,3242400,0,0,0
1931,21,388,3242500,1756,913,843
1932,21,388,3242600,6139,3179,2960
1933,21,388,3242700,285,151,134
1934,21,388,3242800,1696,803,893
1935,21,388,3242900,2395,1234,1161
1936,21,388,3243000,1030,512,518
1937,21,388,3243100,1771,916,855
1938,21,388,3243200,1029,530,499
1939,21,388,3243300,1479,714,765
1940,21,388,3243400,1644,847,797
1941,21,388,3243500,643,331,312
1942,21,388,3243600,0,0,0
1943,21,388,3243700,751,387,364
1944,21,388,3243800,606,292,314
1945,21,388,3243900,1607,748,859
1946,21,388,3244000,636,334,302
1947,21,388,3244100,348,183,165
1948,21,388,3244200,712,367,345
1949,21,388,3244300,1021,483,538
1950,21,388,3244400,1502,758,744
1951,21,388,3244500,3756,1775,1981
1952,21,388,3244600,1263,630,633
1953,21,388,3244700,676,349,327
1954,21,388,3244800,1606,837,769
1955,21,388,3244900,422,226,196
1956,21,388,3245000,595,312,283
1957,21,388,3245100,240,132,108
1958,21,388,3245200,1017,525,492
1959,21,388,3245300,8486,4202,4284
1960,21,388,3245400,1461,750,711
1961,21,388,3245500,480,232,248
1962,21,388,3245600,3263,1577,1686
1963,21,388,3245700,631,308,323
1964,21,388,3245800,2393,1194,1199
1965,21,388,3245900,0,0,0
1966,21,388,3246000,390,197,193
1967,21,388,3246100,3423,1742,1681
1968,21,388,3246200,176,93,83
1969,21,388,3246300,0,0,0
1970,21,388,3246400,2529,1275,1254
1971,21,388,3246500,1223,625,598
1972,21,388,3246600,3415,1758,1657
1973,21,388,3246700,3974,2031,1943
1974,21,388,3246800,1856,955,901
1975,21,388,3246900,1206,606,600
1976,21,388,3247000,436,198,238
1977,21,388,3247100,1190,594,596
1978,21,388,3247200,3224,1613,1611
1979,21,388,3247300,68,41,27
1980,21,388,3247400,208,107,101
1981,21,388,3247500,2847,1368,1479
1982,21,388,3247600,0,0,0
1983,21,388,3247700,224,110,114
1984,21,388,3247800,2108,1013,1095
1985,21,388,3247900,1403,687,716
1986,21,388,3248000,6996,3528,3468
1987,21,388,3248100,430,215,215
1988,21,388,3248200,2743,1403,1340
1989,21,388,3248300,1212,619,593
1990,21,388,3248400,748,395,353
1991,21,388,3248500,479,264,215
1992,21,388,3248600,3232,1578,1654
1993,21,388,3248700,487,237,250
1994,21,388,3248800,2246,1132,1114
1995,21,388,3248900,1680,816,864
1996,21,388,3249000,2162,1107,1055
1997,21,388,3249100,1030,531,499
1998,21,388,3249200,2041,1037,1004
1999,21,388,3249300,0,0,0
2000,21,388,3249400,895,471,424
2001,21,388,3249500,1334,669,665
2002,21,388,3249600,1577,806,771
2003,21,388,3249700,384,208,176
2004,21,388,3249800,864,428,436
2005,21,388,3249900,513,280,233
2006,21,388,3250000,140,68,72
2007,21,388,3250100,1079,535,544
2008,21,388,3250200,794,403,391
2009,21,388,3250300,1517,744,773
2010,21,388,3250400,2180,1081,1099
2011,21,388,3250500,2595,1307,1288
2012,21,388,3250600,4198,2147,2051
2013,21,388,3250700,1013,505,508
2014,21,388,3250800,2688,1297,1391
2015,21,388,3250900,4247,2073,2174
2016,21,388,3251000,1147,576,571
2017,21,388,3251100,2443,1249,1194
2018,21,388,3251200,0,0,0
2019,21,388,3251300,1782,921,861
2020,21,388,3251400,6145,3087,3058
2021,21,388,3251500,5,2,3
2022,21,388,3251600,8673,4344,4329
2023,21,388,3251700,1127,586,541
2024,21,388,3251800,2906,1467,1439
2025,21,388,3251900,1008,490,518
2026,21,388,3252000,5,5,0
2027,21,388,3252100,271,118,153
2028,21,388,3252200,2383,1202,1181
2029,21,388,3252300,1370,642,728
2030,21,388,3252400,573,278,295
2031,21,388,3252500,3254,1596,1658
2032,21,388,3252600,2063,1054,1009
2033,21,388,3252700,2992,1491,1501
2034,21,388,3252800,2092,1065,1027
2035,21,388,3252900,849,433,416
2036,21,388,3253000,824,408,416
2037,21,388,3253100,1664,851,813
2038,21,388,3253200,1874,966,908
2039,21,388,3253300,2347,1233,1114
2040,21,388,3253400,2540,1182,1358
2041,21,388,3253500,2177,1267,910
2042,21,388,3253600,4148,2076,2072
2043,21,388,3253700,1036,544,492
2044,21,388,3253800,3074,1563,1511
2045,21,388,3253900,211,123,88
2046,21,388,3254000,945,449,496
2047,21,388,3254100,1990,997,993
2048,21,388,3254200,3607,1827,1780
2049,21,388,3254300,709,356,353
2050,21,388,3254400,212,115,97
2051,21,388,3254500,462,225,237
2052,21,388,3254600,1865,933,932
2053,21,388,3254700,1442,705,737
2054,21,388,3254800,4584,2306,2278
2055,21,388,3254900,2345,1087,1258
2056,21,388,3255000,9545,5309,4236
2057,21,388,3255100,2938,1346,1592
2058,21,388,3255200,1109,496,613
2059,21,388,3255300,5030,2551,2479
2060,21,388,3255400,3026,1536,1490
2061,21,388,3255500,1520,742,778
2062,21,388,3255600,472,214,258
2063,21,388,3255700,1208,619,589
2064,21,388,3255800,1962,984,978
2065,21,388,3255900,1598,789,809
2066,21,388,3256000,2746,1368,1378
2067,21,388,3256100,2303,1175,1128
2068,21,388,3256200,3052,1572,1480
2069,21,388,3256300,2601,1336,1265
2070,21,388,3256400,1746,918,828
2071,21,388,3256500,2517,1299,1218
2072,21,388,3256600,1510,770,740
2073,21,388,3256700,2561,1243,1318
2074,21,388,3256800,649,312,337
2075,21,388,3256900,52,25,27
2076,21,388,3257000,638,327,311
2077,21,388,3257100,1396,688,708
2078,21,388,3257200,851,428,423
2079,21,388,3257300,7208,3615,3593
2080,21,388,3257400,1886,932,954
2081,21,388,3257500,1923,1004,919
2082,21,388,3257600,4833,2582,2251
2083,21,388,3257700,2252,1140,1112
2084,21,388,3257800,1902,954,948
2085,21,388,3257900,1884,975,909
2086,21,388,3258000,1487,742,745
2087,21,388,3258100,1115,548,567
2088,21,388,3258200,965,468,497
2089,21,388,3258300,5980,3104,2876
2090,21,388,3258400,2974,1553,1421
2091,21,388,3258500,4926,2482,2444
2092,21,388,3258600,1394,686,708
2093,21,388,3258700,270,137,133
2094,21,388,3258800,2514,1255,1259
2095,21,388,3258900,3051,1552,1499
2096,21,388,3259000,516,269,247
2097,21,388,3259100,4773,2424,2349
2098,21,388,3259200,1358,668,690
2099,21,388,3259300,2234,1074,1160
2100,21,388,3259400,2017,1001,1016
2101,21,388,3259500,7464,3763,3701
2102,21,388,3259600,10316,5423,4893
2103,21,388,3259700,2949,1496,1453
2104,21,388,3259800,6603,3370,3233
2105,21,388,3259900,2975,1528,1447
2106,21,388,3260000,1508,730,778
2107,21,388,3260100,2064,1020,1044
2108,21,388,3260200,0,0,0
2109,21,388,3260300,4577,2325,2252
2110,21,388,3260400,0,0,0
2111,21,388,3260500,1227,659,568
2112,21,388,3260600,0,0,0
2113,21,388,3260700,0,0,0
2114,21,388,3260800,1576,797,779
2115,21,388,3260900,978,511,467
2116,21,388,3261000,0,0,0
2117,21,388,3261100,1027,510,517
2118,21,388,3261200,906,467,439
2119,21,388,3261300,2183,1076,1107
2120,21,388,3261400,1741,888,853
2121,21,388,3261500,748,356,392
2122,21,388,3261600,1126,597,529
2123,21,388,3261700,1557,796,761
2124,21,388,3261800,2536,1281,1255
2125,21,388,3261900,2814,1449,1365
2126,21,388,3262000,1378,721,657
2127,21,388,3262100,920,493,427
2128,21,388,3262200,2469,1277,1192
2129,21,388,3262300,359,202,157
2130,21,388,3262400,907,433,474
2131,21,388,3262500,4290,2229,2061
2132,21,388,3262600,2754,1413,1341
2133,21,388,3262700,1043,537,506
2134,21,388,3262800,2719,1400,1319
2135,21,388,3262900,853,425,428
2136,21,388,3263000,52,27,25
2137,21,388,3263100,150,68,82
2138,21,388,3263200,3461,1691,1770
2139,21,388,3263300,5447,2776,2671
2140,21,388,3263400,3303,1645,1658
2141,21,388,3263500,1335,627,708
2142,21,388,3263600,1326,678,648
2143,21,388,3263700,2360,1203,1157
2144,21,388,3263800,673,309,364
2145,21,388,3263900,1482,682,800
2146,21,388,3264000,1721,844,877
2147,21,388,3264100,519,238,281
2148,21,388,3264200,1600,774,826
2149,21,388,3264300,798,360,438
2150,21,388,3264400,1151,569,582
2151,21,388,3264500,736,377,359
2152,21,388,3264600,1260,615,645
2153,21,388,3264700,4024,1960,2064
2154,21,388,3264800,1994,994,1000
2155,21,388,3264900,2494,1228,1266
2156,21,388,3265000,944,463,481
2157,21,388,3265100,826,426,400
2158,21,388,3265200,2411,1208,1203
2159,21,388,3265300,317,161,156
2160,21,388,3265400,350,166,184
2161,21,388,3265500,359,185,174
2162,21,388,3265600,73,40,33
2163,21,388,3265700,394,198,196
2164,21,388,3265800,485,231,254
2165,21,388,3265900,352,168,184
2166,21,388,3266000,714,350,364
2167,21,388,3266100,291,152,139
2168,21,388,3266200,484,234,250
2169,21,388,3266300,534,248,286
2170,21,388,3266400,1765,840,925
2171,21,388,3266500,423,218,205
2172,21,388,3266600,363,176,187
2173,21,388,3266700,796,406,390
2174,21,388,3266800,186,91,95
2175,21,388,3266900,3639,1749,1890
2176,21,388,3267000,1707,839,868
2177,21,388,3267100,1376,675,701
2178,21,388,3267200,228,111,117
2179,21,388,3267300,1449,677,772
2180,21,388,3267400,568,274,294
2181,21,388,3267500,203,94,109
2182,21,388,3267600,2205,1017,1188
2183,21,388,3267700,705,323,382
2184,21,388,3267800,443,192,251
2185,21,388,3267900,1467,698,769
2186,21,388,3268000,2848,1424,1424
2187,21,388,3268100,1307,666,641
2188,21,388,3268200,389,186,203
2189,21,388,3268300,626,291,335
2190,21,388,3268400,1409,668,741
2191,21,388,3268500,2177,1018,1159
2192,21,388,3268600,2897,1420,1477
2193,21,388,3268700,1079,505,574
2194,21,388,3268800,2711,1247,1464
2195,21,388,3268900,1706,802,904
2196,21,388,3269000,8289,4105,4184
2197,21,388,3269100,0,0,0
2198,21,388,3269200,7453,3800,3653
2199,21,388,3269300,341,158,183
2200,21,388,3269400,2102,1037,1065
2201,21,388,3269500,330,149,181
2202,21,388,3269600,1776,905,871
2203,21,388,3269700,4805,2401,2404
2204,21,388,3269800,1450,734,716
2205,21,388,3269900,3335,1605,1730
2206,21,388,3270000,1741,872,869
2207,21,388,3270100,682,340,342
2208,21,388,3270200,259,130,129
2209,21,388,3270300,1146,595,551
2210,21,388,3270400,426,218,208
2211,21,388,3270500,25,13,12
2212,21,388,3270600,85,43,42
2213,21,388,3270700,322,173,149
2214,21,388,3270800,1243,626,617
2215,21,388,3270900,315,158,157
2216,21,388,3271000,0,0,0
2217,21,388,3271100,126,60,66
2218,21,388,3271200,189,92,97
2219,21,388,3271300,212,103,109
2220,21,388,3271400,266,121,145
2221,21,388,3271500,69,32,37
2222,21,388,3271600,903,470,433
2223,21,388,3271700,339,174,165
2224,21,388,3271800,1592,816,776
2225,21,388,3271900,214,116,98
2226,21,388,3272000,295,145,150
2227,21,388,3272100,148,77,71
2228,21,388,3272200,596,301,295
2229,21,388,3272300,353,174,179
2230,21,388,3272400,481,209,272
2231,21,388,3272500,420,195,225
2232,21,388,3272600,89,42,47
2233,21,388,3272700,2340,1200,1140
2234,21,388,3272800,1211,611,600
2235,21,388,3272900,142,70,72
2236,21,388,3273000,711,339,372
2237,21,388,3273100,160,83,77
2238,21,388,3273200,112,51,61
2239,21,388,3273300,102,45,57
2240,21,388,3273400,142,71,71
2241,21,388,3273500,305,152,153
2242,21,388,3273600,950,445,505
2243,21,388,3273700,123,62,61
2244,21,388,3273800,0,0,0
2245,21,388,3273900,107,58,49
2246,21,388,3274000,144,74,70
2247,21,388,3274100,0,0,0
2248,21,388,3274200,0,0,0
2249,21,388,3274300,55,25,30
2250,21,388,3274400,464,241,223
2251,21,388,3274500,64,31,33
2252,21,388,3274600,1310,653,657
2253,21,388,3274700,753,368,385
2254,21,388,3274800,764,360,404
2255,21,388,3274900,130,59,71
2256,21,388,3275000,0,0,0
2257,21,388,3275100,486,234,252
2258,21,388,3275200,2219,1086,1133
2259,21,388,3275300,562,281,281
2260,21,388,3275400,1317,627,690
2261,21,388,3275500,760,396,364
2262,21,388,3275600,30,11,19
2263,21,388,3275700,0,0,0
2264,21,388,3275800,175,87,88
2265,21,388,3275900,29,16,13
2266,21,388,3276000,21,7,14
2267,21,388,3276100,128,59,69
2268,21,388,3276200,97,50,47
2269,21,388,3276300,12,5,7
2270,21,388,3276400,31,14,17
2271,21,388,3276500,62,30,32
2272,21,388,3276600,72,40,32
2273,21,388,3276700,93,50,43
2274,21,388,3276800,123,63,60
2275,21,388,3276900,90,43,47
2276,21,388,3277000,0,0,0
2277,21,388,3277100,44,21,23
2278,21,388,3277200,1392,721,671
2279,21,388,3277300,137,63,74
2280,21,388,3277400,190,92,98
2281,21,388,3277500,89,50,39
2282,21,388,3277600,107,48,59
2283,21,388,3277700,522,253,269
2284,21,388,3277800,135,62,73
2285,21,388,3277900,601,297,304
2286,21,388,3278000,154,82,72
2287,21,388,3278100,342,169,173
2288,21,388,3278200,861,441,420
2289,21,388,3278300,815,400,415
2290,21,388,3278400,773,368,405
2291,21,388,3278500,102,43,59
2292,21,388,3278600,754,387,367
2293,21,388,3278700,146,73,73
2294,21,388,3278800,80,41,39
2295,21,388,3278900,0,0,0
2296,21,388,3279000,70,36,34
2297,21,388,3279100,1,1,0
2298,21,388,3279200,130,65,65
2299,21,388,3279300,0,0,0
2300,21,388,3279400,102,52,50
2301,21,388,3279500,0,0,0
2302,21,388,3279600,404,203,201
2303,21,388,3279700,0,0,0
2304,21,388,3279800,112,53,59
2305,21,388,3279900,937,462,475
2306,21,388,3280000,367,175,192
2307,21,388,3280100,0,0,0
2308,21,388,3280200,658,342,316
2309,21,388,3280300,764,358,406
2310,21,388,3280400,273,151,122
2311,21,388,3280500,2704,1326,1378
2312,21,388,3280600,969,481,488
2313,21,388,3280700,72,40,32
2314,21,388,3280800,0,0,0
2315,21,388,3280900,290,139,151
2316,21,388,3281000,782,397,385
2317,21,388,3281100,2628,1285,1343
2318,21,388,3281200,0,0,0
2319,21,388,3281300,1310,685,625
2320,21,388,3281400,444,226,218
2321,21,388,3281500,96,49,47
2322,21,388,3281600,0,0,0
2323,21,388,3281700,1927,963,964
2324,21,388,3281800,321,154,167
2325,21,388,3281900,198,89,109
2326,21,388,3282000,393,190,203
2327,21,388,3282100,589,299,290
2328,21,388,3282200,810,416,394
2329,21,388,3282300,826,441,385
2330,21,388,3282400,1281,621,660
2331,21,388,3282500,965,467,498
2332,21,388,3282600,408,208,200
2333,21,388,3282700,75,41,34
2334,21,388,3282800,46,23,23
2335,21,388,3282900,6,4,2
2336,21,388,3283000,60,30,30
2337,21,388,3283100,70,31,39
2338,21,388,3283200,60,24,36
2339,21,388,3283300,63,34,29
2340,21,388,3283400,538,290,248
2341,21,388,3283500,174,82,92
2342,21,388,3283600,1083,534,549
2343,21,388,3283700,1010,521,489
2344,21,388,3283800,1984,989,995
2345,21,388,3283900,384,181,203
2346,21,388,3284000,51,26,25
2347,21,388,3284100,0,0,0
2348,21,388,3284200,2485,1270,1215
2349,21,388,3284300,0,0,0
2350,21,388,3284400,275,146,129
2351,21,388,3284500,122,69,53
2352,21,388,3284600,196,96,100
2353,21,388,3284700,72,35,37
2354,21,388,3284800,4621,2324,2297
2355,21,388,3284900,270,149,121
2356,21,388,3285000,397,204,193
2357,21,388,3285100,696,350,346
2358,21,388,3285200,0,0,0
2359,21,388,3285300,494,240,254
2360,21,388,3285400,197,96,101
2361,21,388,3285500,1247,637,610
2362,21,388,3285600,1019,495,524
2363,21,388,3285700,197,98,99
2364,21,388,3285800,628,293,335
2365,21,388,3285900,128,68,60
2366,21,388,3286000,438,226,212
2367,21,388,3286100,0,0,0
2368,21,388,3286200,954,444,510
2369,21,388,3286300,202,91,111
2370,21,388,3286400,17,7,10
2371,21,388,3286500,715,353,362
2372,21,388,3286600,1191,590,601
2373,21,388,3286700,390,208,182
2374,21,388,3286800,301,159,142
2375,21,388,3286900,221,101,120
2376,21,388,3287000,594,289,305
2377,21,388,3287100,1128,535,593
2378,21,388,3287200,1196,602,594
2379,21,388,3287300,618,309,309
2380,21,388,3287400,2129,1078,1051
2381,21,388,3287500,257,126,131
2382,21,388,3287600,1300,665,635
2383,21,388,3287700,256,136,120
2384,21,388,3287800,367,186,181
2385,21,388,3287900,0,0,0
2386,21,388,3288000,0,0,0
2387,21,388,3288100,1121,578,543
2388,21,388,3288200,872,420,452
2389,21,388,3288300,257,122,135
2390,21,388,3288400,616,299,317
2391,21,388,3288500,1156,533,623
2392,21,388,3288600,592,291,301
2393,21,388,3288700,433,213,220
2394,21,388,3288800,0,0,0
2395,21,388,3288900,119,61,58
2396,21,388,3289000,1489,746,743
2397,21,388,3289100,946,429,517
2398,21,388,3289200,377,190,187
2399,21,388,3289300,0,0,0
2400,21,388,3289400,2968,1365,1603
2401,21,388,3289500,315,163,152
2402,21,388,3289600,1265,545,720
2403,21,388,3289700,1319,587,732
2404,21,388,3289800,36,16,20
2405,21,388,3289900,423,206,217
2406,21,388,3290000,483,240,243
2407,21,388,3290100,369,174,195
2408,21,388,3290200,7313,3771,3542
2409,21,388,3290300,3475,1742,1733
2410,21,388,3290400,4133,2073,2060
2411,21,388,3290500,3005,1469,1536
2412,21,388,3290600,772,404,368
2413,21,388,3290700,0,0,0
2414,21,388,3290800,15,8,7
2415,21,388,3290900,1375,734,641
2416,21,388,3291000,1158,581,577
2417,21,388,3291100,0,0,0
2418,21,388,3291200,0,0,0
2419,21,388,3291300,482,241,241
2420,21,388,3291400,1093,541,552
2421,21,388,3291500,1850,921,929
2422,21,388,3291600,0,0,0
2423,21,388,3291700,1311,617,694
2424,21,388,3291800,2520,1298,1222
2425,21,388,3291900,410,185,225
2426,21,388,3292000,828,371,457
2427,21,388,3292100,1966,923,1043
2428,21,388,3292200,1204,629,575
2429,21,388,3292300,3487,1691,1796
2430,21,388,3292400,922,481,441
2431,21,388,3292500,540,266,274
2432,21,388,3292600,674,337,337
2433,21,388,3292700,447,235,212
2434,21,388,3292800,4542,2296,2246
2435,21,388,3292900,1442,781,661
2436,21,388,3293000,1684,870,814
2437,21,388,3293100,0,0,0
2438,21,388,3293200,644,330,314
2439,21,388,3293300,222,112,110
2440,21,388,3293400,840,415,425
2441,21,388,3293500,205,100,105
2442,21,388,3293600,0,0,0
2443,21,388,3293700,1143,600,543
2444,21,388,3293800,590,267,323
2445,21,388,3293900,1367,644,723
2446,21,388,3294000,960,481,479
2447,21,388,3294100,543,253,290
2448,21,388,3294200,331,152,179
2449,21,388,3294300,1155,532,623
2450,21,388,3294400,427,189,238
2451,21,388,3294500,1557,757,800
2452,21,388,3294600,995,472,523
2453,21,388,3294700,801,407,394
2454,21,388,3294800,2987,1463,1524
2455,21,388,3294900,1152,605,547
2456,21,388,3295000,232,115,117
2457,21,388,3295100,939,452,487
2458,21,388,3295200,0,0,0
2459,21,388,3295300,246,123,123
2460,21,388,3295400,100,53,47
2461,21,388,3295500,1008,505,503
2462,21,388,3295600,0,0,0
2463,21,388,3295700,523,265,258
2464,21,388,3295800,1234,637,597
2465,21,388,3295900,1270,650,620
2466,21,388,3296000,0,0,0
2467,21,388,3296100,1300,644,656
2468,21,388,3296200,1577,786,791
2469,21,388,3296300,1589,825,764
2470,21,388,3296400,634,321,313
2471,21,388,3296500,1884,896,988
2472,21,388,3296600,487,246,241
2473,21,388,3296700,3,2,1
2474,21,388,3296800,297,155,142
2475,21,388,3296900,1100,545,555
2476,21,388,3297000,1181,608,573
2477,21,388,3297100,949,484,465
2478,21,388,3297200,1585,793,792
2479,21,388,3297300,0,0,0
2480,21,388,3297400,520,262,258
2481,21,388,3297500,334,183,151
2482,21,388,3297600,731,362,369
2483,21,388,3297700,815,407,408
2484,21,388,3297800,185,94,91
2485,21,388,3297900,444,234,210
2486,21,388,3298000,169,98,71
2487,21,388,3298100,1921,937,984
2488,21,388,3298200,738,353,385
2489,21,388,3298300,1234,567,667
2490,21,388,3298400,1098,494,604
2491,21,388,3298500,776,343,433
2492,21,388,3298600,2229,1094,1135
2493,21,388,3298700,149,77,72
2494,21,388,3298800,171,88,83
2495,21,388,3298900,158,78,80
2496,21,388,3299000,137,62,75
2497,21,388,3299100,103,48,55
2498,21,388,3299200,0,0,0
2499,21,388,3299300,0,0,0
2500,21,388,3299400,80,43,37
2501,21,388,3299500,208,97,111
2502,21,388,3299600,301,166,135
2503,21,388,3299700,140,62,78
2504,21,388,3299800,138,69,69
2505,21,388,3299900,18,14,4
2506,21,388,3300000,1731,870,861
2507,21,388,3300100,89,42,47
2508,21,388,3300200,50,26,24
2509,21,388,3300300,147,81,66
2510,21,388,3300400,4064,2106,1958
2511,21,388,3300500,3213,1637,1576
2512,21,388,3300600,78,37,41
2513,21,388,3300700,224,110,114
2514,21,388,3300800,194,91,103
2515,21,388,3300900,698,328,370
2516,21,388,3301000,126,55,71
2517,21,388,3301100,0,0,0
2518,21,388,3301200,83,40,43
2519,21,388,3301300,32,17,15
2520,21,388,3301400,0,0,0
2521,21,388,3301500,46,21,25
2522,21,388,3301600,0,0,0
2523,21,388,3301700,0,0,0
2524,21,388,3301800,130,65,65
2525,21,388,3301900,225,110,115
2526,21,388,3302000,80,40,40
2527,21,388,3302100,158,73,85
2528,21,388,3302200,1966,940,1026
2529,21,388,3302300,234,117,117
2530,21,388,3302400,1070,563,507
2531,21,388,3302500,911,419,492
2532,21,388,3302600,327,159,168
2533,21,388,3302700,1046,518,528
2534,21,388,3302800,874,428,446
2535,21,388,3302900,183,90,93
2536,21,388,3303000,365,181,184
2537,21,388,3303100,531,265,266
2538,21,388,3303200,75,44,31
2539,21,388,3303300,1084,550,534
2540,21,388,3303400,606,302,304
2541,21,388,3303500,504,262,242
2542,21,388,3303600,0,0,0
2543,21,388,3303700,998,513,485
2544,21,388,3303800,1849,896,953
2545,21,388,3303900,121,65,56
2546,21,388,3304000,55,27,28
2547,21,388,3304100,381,205,176
2548,21,388,3304200,298,157,141
2549,21,388,3304300,209,104,105
2550,21,388,3304400,326,171,155
2551,21,388,3304500,2686,1346,1340
2552,21,388,3304600,103,51,52
2553,21,388,3304700,0,0,0
2554,21,388,3304800,236,127,109
2555,21,388,3304900,96,50,46
2556,21,388,3305000,91,56,35
2557,21,388,3305100,88,40,48
2558,21,388,3305200,101,54,47
2559,21,388,3305300,0,0,0
2560,21,388,3305400,25,11,14
2561,21,388,3305500,94,53,41
2562,21,388,3305600,59,31,28
2563,21,388,3305700,0,0,0
2564,21,388,3305800,0,0,0
2565,21,388,3305900,351,176,175
2566,21,388,3306000,0,0,0
2567,21,388,3306100,160,84,76
2568,21,388,3306200,2,2,0
2569,21,388,3306300,3327,1678,1649
2570,21,388,3306400,75,35,40
2571,21,388,3306500,0,0,0
2572,21,388,3306600,113,56,57
2573,21,388,3306700,121,65,56
2574,21,388,3306800,0,0,0
2575,21,388,3306900,96,52,44
2576,21,388,3307000,188,106,82
2577,21,388,3307100,309,140,169
2578,21,388,3307200,181,81,100
2579,21,388,3307300,276,131,145
2580,21,388,3307400,99,51,48
2581,21,388,3307500,77,42,35
2582,21,388,3307600,132,71,61
2583,21,388,3307700,217,111,106
2584,21,388,3307800,83,45,38
2585,21,388,3307900,0,0,0
2586,21,388,3308000,0,0,0
2587,21,388,3308100,867,428,439
2588,21,388,3308200,0,0,0
2589,21,388,3308300,1908,969,939
2590,21,388,3308400,598,298,300
2591,21,388,3308500,353,167,186
2592,21,388,3308600,474,233,241
2593,21,388,3308700,0,0,0
2594,21,388,3308800,927,475,452
2595,21,388,3308900,791,429,362
2596,21,388,3309000,830,403,427
2597,21,388,3309100,709,353,356
2598,21,388,3309200,800,378,422
2599,21,388,3309300,1878,935,943
2600,21,388,3309400,0,0,0
2601,21,388,3309500,568,281,287
2602,21,388,3309600,0,0,0
2603,21,388,3309700,0,0,0
2604,21,388,3309800,688,334,354
2605,21,388,3309900,0,0,0
2606,21,388,3310000,1307,678,629
2607,21,388,3310100,0,0,0
2608,21,388,3310200,10,6,4
2609,21,388,3310300,0,0,0
2610,21,388,3310400,0,0,0
2611,21,388,3310500,304,158,146
2612,21,388,3310600,204,108,96
2613,21,388,3310700,487,246,241
2614,21,388,3310800,295,140,155
2615,21,388,3310900,586,302,284
2616,21,388,3311000,1036,527,509
2617,21,388,3311100,1244,586,658
2618,21,388,3311200,1383,659,724
2619,21,388,3311300,1653,794,859
2620,21,388,3311400,1211,621,590
2621,21,388,3311500,448,236,212
2622,21,388,3311600,1909,974,935
2623,21,388,3311700,1157,585,572
2624,21,388,3311800,501,246,255
2625,21,388,3311900,2101,1054,1047
2626,21,388,3312000,1971,971,1000
2627,21,388,3312100,485,242,243
2628,21,388,3312200,502,225,277
2629,21,388,3312300,0,0,0
2630,21,388,3312400,0,0,0
2631,21,388,3312500,0,0,0
2632,21,388,3312600,295,155,140
2633,21,388,3312700,0,0,0
2634,21,388,3312800,0,0,0
2635,21,388,3312900,1554,791,763
2636,21,388,3313000,955,449,506
2637,21,388,3313100,0,0,0
2638,21,388,3313200,0,0,0
2639,21,388,3313300,0,0,0
2640,21,388,3313400,491,246,245
2641,21,388,3313500,42,20,22
2642,21,388,3313600,14,6,8
2643,21,388,3313700,135,69,66
2644,21,388,3313800,0,0,0
2645,21,388,3313900,0,0,0
2646,21,388,3314000,43,25,18
2647,21,388,3314100,16,7,9
2648,21,388,3314200,106,51,55
2649,21,388,3314300,84,52,32
2650,21,388,3314400,0,0,0
2651,21,388,3314500,173,81,92
2652,21,388,3314600,235,122,113
2653,21,388,3314700,494,248,246
2654,21,388,3314800,579,307,272
2655,21,388,3314900,1117,573,544
2656,21,388,3315000,173,103,70
2657,21,388,3315100,248,126,122
2658,21,388,3315200,122,61,61
2659,21,388,3315300,82,41,41
2660,21,388,3315400,0,0,0
2661,21,388,3315500,1167,581,586
2662,21,388,3315600,104,56,48
2663,21,388,3315700,0,0,0
2664,21,388,3315800,0,0,0
2665,21,388,3315900,511,236,275
2666,21,388,3316000,0,0,0
2667,21,388,3316100,1147,541,606
2668,21,388,3316200,318,147,171
2669,21,388,3316300,561,286,275
2670,21,388,3316400,3214,1641,1573
2671,21,388,3316500,257,118,139
2672,21,388,3316600,303,158,145
2673,21,388,3316700,360,156,204
2674,21,388,3316800,0,0,0
2675,21,388,3316900,146,75,71
2676,21,388,3317000,1103,573,530
2677,21,388,3317100,612,298,314
2678,21,388,3317200,6883,3476,3407
2679,21,388,3317300,407,200,207
2680,21,388,3317400,420,212,208
2681,21,388,3317500,633,302,331
2682,21,388,3317600,237,118,119
2683,21,388,3317700,416,175,241
2684,21,388,3317800,216,107,109
2685,21,388,3317900,0,0,0
2686,21,388,3318000,60,27,33
2687,21,388,3318100,0,0,0
2688,21,388,3318200,0,0,0
2689,21,388,3318300,31,18,13
2690,21,388,3318400,122,58,64
2691,21,388,3318500,40,14,26
2692,21,388,3318600,0,0,0
2693,21,388,3318700,63,23,40
2694,21,388,3318800,68,33,35
2695,21,388,3318900,93,53,40
2696,21,388,3319000,63,33,30
2697,21,388,3319100,391,198,193
2698,21,388,3319200,0,0,0
2699,21,388,3319300,56,26,30
2700,21,388,3319400,0,0,0
2701,21,388,3319500,46,26,20
2702,21,388,3319600,0,0,0
2703,21,388,3319700,0,0,0
2704,21,388,3319800,0,0,0
2705,21,388,3319900,0,0,0
2706,21,388,3320000,63,36,27
2707,21,388,3320100,41,18,23
2708,21,388,3320200,0,0,0
2709,21,388,3320300,22,8,14
2710,21,388,3320400,0,0,0
2711,21,388,3320500,41,23,18
2712,21,388,3320600,15,8,7
2713,21,388,3320700,5,2,3
2714,21,388,3320800,39,18,21
2715,21,388,3320900,0,0,0
2716,21,388,3321000,48,26,22
2717,21,388,3321100,27,14,13
2718,21,388,3321200,0,0,0
2719,21,388,3321300,88,45,43
2720,21,388,3321400,61,36,25
2721,21,388,3321500,0,0,0
2722,21,388,3321600,912,458,454
2723,21,388,3321700,550,255,295
2724,21,388,3321800,351,174,177
2725,21,388,3321900,792,403,389
2726,21,388,3322000,260,125,135
2727,21,388,3322100,962,502,460
2728,21,388,3322200,1351,676,675
2729,21,388,3322300,727,332,395
2730,21,388,3322400,1688,805,883
2731,21,388,3322500,378,176,202
2732,21,388,3322600,1491,674,817
2733,21,388,3322700,525,243,282
2734,21,388,3322800,677,332,345
2735,21,388,3322900,1035,475,560
2736,21,388,3323000,808,391,417
2737,21,388,3323100,368,193,175
2738,21,388,3323200,1717,867,850
2739,21,388,3323300,1146,571,575
2740,21,388,3323400,15,6,9
2741,21,388,3323500,674,338,336
2742,21,388,3323600,43,16,27
2743,21,388,3323700,46,25,21
2744,21,388,3323800,35,15,20
2745,21,388,3323900,0,0,0
2746,21,388,3324000,43,17,26
2747,21,388,3324100,15,5,10
2748,21,388,3324200,104,49,55
2749,21,388,3324300,729,366,363
2750,21,388,3324400,379,194,185
2751,21,388,3324500,904,444,460
2752,21,388,3324600,1489,727,762
2753,21,388,3324700,366,157,209
2754,21,388,3324800,1514,625,889
2755,21,388,3324900,1515,771,744
2756,21,388,3325000,1,1,0
2757,21,388,3325100,434,228,206
2758,21,388,3325200,0,0,0
2759,21,388,3325300,1075,523,552
2760,21,388,3325400,1261,569,692
2761,21,388,3325500,724,320,404
2762,21,388,3325600,970,458,512
2763,21,388,3325700,404,186,218
2764,21,388,3325800,973,481,492
2765,21,388,3325900,1756,731,1025
2766,21,388,3326000,855,377,478
2767,21,388,3326100,487,189,298
2768,21,388,3326200,4136,1976,2160
2769,21,388,3326300,731,323,408
2770,21,388,3326400,790,394,396
2771,21,388,3326500,614,272,342
2772,21,388,3326600,784,343,441
2773,21,388,3326700,788,360,428
2774,21,388,3326800,589,273,316
2775,21,388,3326900,260,138,122
2776,21,388,3327000,310,150,160
2777,21,388,3327100,682,314,368
2778,21,388,3327200,161,73,88
2779,21,388,3327300,1288,642,646
2780,21,388,3327400,390,192,198
2781,21,388,3327500,2849,1383,1466
2782,21,388,3327600,33,15,18
2783,21,388,3327700,23,8,15
2784,21,388,3327800,120,55,65
2785,21,388,3327900,1161,599,562
2786,21,388,3328000,247,122,125
2787,21,388,3328100,410,203,207
2788,21,388,3328200,930,471,459
2789,21,388,3328300,77,43,34
2790,21,388,3328400,363,157,206
2791,21,388,3328500,1033,494,539
2792,21,388,3328600,96,45,51
2793,21,388,3328700,63,30,33
2794,21,388,3328800,496,244,252
2795,21,388,3328900,155,83,72
2796,21,388,3329000,111,58,53
2797,21,388,3329100,545,275,270
2798,21,388,3329200,435,202,233
2799,21,388,3329300,101,52,49
2800,21,388,3329400,0,0,0
2801,21,388,3329500,2460,1208,1252
2802,21,388,3329600,888,415,473
2803,21,388,3329700,1318,540,778
2804,21,388,3329800,1196,558,638
2805,21,388,3329900,93,50,43
2806,21,388,3330000,159,79,80
2807,21,388,3330100,168,89,79
2808,21,388,3330200,237,118,119
2809,21,388,3330300,324,161,163
2810,21,388,3330400,107,41,66
2811,21,388,3330500,483,223,260
2812,21,388,3330600,243,119,124
2813,21,388,3330700,49,23,26
2814,21,388,3330800,24,11,13
2815,21,388,3330900,160,77,83
2816,21,388,3331000,51,32,19
2817,21,388,3331100,102,56,46
2818,21,388,3331200,34,21,13
2819,21,388,3331300,146,73,73
2820,21,388,3331400,39,16,23
2821,21,388,3331500,144,59,85
2822,21,388,3331600,272,129,143
2823,21,388,3331700,0,0,0
2824,21,388,3331800,0,0,0
2825,21,388,3331900,85,41,44
2826,21,388,3332000,286,125,161
2827,21,388,3332100,77,34,43
2828,21,388,3332200,591,281,310
2829,21,388,3332300,157,62,95
2830,21,388,3332400,636,391,245
2831,21,388,3332500,263,132,131
2832,21,388,3332600,399,187,212
2833,21,388,3332700,206,90,116
2834,21,388,3332800,177,90,87
2835,21,388,3332900,89,41,48
2836,21,388,3333000,121,61,60
2837,21,388,3333100,219,117,102
2838,21,388,3333200,185,91,94
2839,21,388,3333300,927,487,440
2840,21,388,3333400,361,193,168
2841,21,388,3333500,1493,730,763
2842,21,388,3333600,7570,3827,3743
2843,21,388,3333700,782,389,393
2844,21,388,3333800,1367,704,663
2845,21,388,3333900,709,343,366
2846,21,388,3334000,432,236,196
2847,21,388,3334100,1732,848,884
2848,21,388,3334200,1491,755,736
2849,21,388,3334300,1276,668,608
2850,21,388,3334400,1253,646,607
2851,21,388,3334500,853,447,406
2852,21,388,3334600,1493,743,750
2853,21,388,3334700,681,346,335
2854,21,388,3334800,1459,754,705
2855,21,388,3334900,778,409,369
2856,21,388,3335000,1050,518,532
2857,21,388,3335100,200,94,106
2858,21,388,3335200,0,0,0
2859,21,388,3335300,0,0,0
2860,21,388,3335400,0,0,0
2861,21,388,3335500,1167,626,541
2862,21,388,3335600,340,187,153
2863,21,388,3335700,0,0,0
2864,21,388,3335800,2120,1046,1074
2865,21,388,3335900,1179,605,574
2866,21,388,3336000,0,0,0
2867,21,388,3336100,3536,1817,1719
2868,21,388,3336200,1148,540,608
2869,21,388,3336300,1723,903,820
2870,21,388,3336400,631,274,357
2871,21,388,3336500,1126,534,592
2872,21,388,3336600,597,294,303
2873,21,388,3336700,1138,563,575
2874,21,388,3336800,1151,578,573
2875,21,388,3336900,1511,776,735
2876,21,388,3337000,3057,1587,1470
2877,21,388,3337100,703,352,351
2878,21,388,3337200,619,320,299
2879,21,388,3337300,568,290,278
2880,21,388,3337400,3165,1573,1592
2881,21,388,3337500,2036,1084,952
2882,21,388,3337600,96,51,45
2883,21,388,3337700,123,64,59
2884,21,388,3337800,267,131,136
2885,21,388,3337900,0,0,0
2886,21,388,3338000,0,0,0
2887,21,388,3338100,0,0,0
2888,21,388,3338200,1594,826,768
2889,21,388,3338300,805,350,455
2890,21,388,3338400,552,274,278
2891,21,388,3338500,214,116,98
2892,21,388,3338600,638,328,310
2893,21,388,3338700,1400,731,669
2894,21,388,3338800,370,194,176
2895,21,388,3338900,994,521,473
2896,21,388,3339000,955,471,484
2897,21,388,3339100,1630,857,773
2898,21,388,3339200,1282,637,645
2899,21,388,3339300,2093,1020,1073
2900,21,388,3339400,6009,3092,2917
2901,21,388,3339500,820,429,391
2902,21,388,3339600,44,25,19
2903,21,388,3339700,51,24,27
2904,21,388,3339800,2276,1213,1063
2905,21,388,3339900,581,292,289
2906,21,388,3340000,3479,1871,1608
2907,21,388,3340100,926,480,446
2908,21,388,3340200,944,515,429
2909,21,388,3340300,1632,855,777
2910,21,388,3340400,2683,1393,1290
2911,21,388,3340500,0,0,0
2912,21,388,3340600,687,355,332
2913,21,388,3340700,275,138,137
2914,21,388,3340800,1087,567,520
2915,21,388,3340900,1213,650,563
2916,21,388,3341000,1939,961,978
2917,21,388,3341100,5849,3101,2748
2918,21,388,3341200,2956,1604,1352
2919,21,388,3341300,3724,1971,1753
2920,21,388,3341400,474,240,234
2921,21,388,3341500,3002,1492,1510
2922,21,388,3341600,0,0,0
2923,21,388,3341700,1348,726,622
2924,21,388,3341800,1531,727,804
2925,21,388,3341900,22,11,11
2926,21,388,3342000,980,518,462
2927,21,388,3342100,0,0,0
2928,21,388,3342200,2168,1115,1053
2929,21,388,3342300,262,128,134
2930,21,388,3342400,227,118,109
2931,21,388,3342500,42,16,26
2932,21,388,3342600,259,126,133
2933,21,388,3342700,577,284,293
2934,21,388,3342800,0,0,0
2935,21,388,3342900,1279,661,618
2936,21,388,3343000,64,33,31
2937,21,388,3343100,109,54,55
2938,21,388,3343200,845,427,418
2939,21,388,3343300,288,146,142
2940,21,388,3343400,0,0,0
2941,21,388,3343500,414,198,216
2942,21,388,3343600,273,141,132
2943,21,388,3343700,1140,568,572
2944,21,388,3343800,261,119,142
2945,21,388,3343900,409,203,206
2946,21,388,3344000,417,197,220
2947,21,388,3344100,0,0,0
2948,21,388,3344200,437,223,214
2949,21,388,3344300,1400,678,722
2950,21,388,3344400,1204,605,599
2951,21,388,3344500,535,263,272
2952,21,388,3344600,410,217,193
2953,21,388,3344700,323,164,159
2954,21,388,3344800,224,115,109
2955,21,388,3344900,746,336,410
2956,21,388,3345000,434,215,219
2957,21,388,3345100,78,45,33
2958,21,388,3345200,128,58,70
2959,21,388,3345300,0,0,0
2960,21,388,3345400,121,61,60
2961,21,388,3345500,1836,901,935
2962,21,388,3345600,192,87,105
2963,21,388,3345700,511,253,258
2964,21,388,3345800,1454,755,699
2965,21,388,3345900,1977,966,1011
2966,21,388,3346000,6479,3265,3214
2967,21,388,3346100,3317,1710,1607
2968,21,388,3346200,1042,525,517
2969,21,388,3346300,912,470,442
2970,21,388,3346400,3187,1662,1525
2971,21,388,3346500,1340,686,654
2972,21,388,3346600,1192,627,565
2973,21,388,3346700,4426,2282,2144
2974,21,388,3346800,2321,1195,1126
2975,21,388,3346900,0,0,0
2976,21,388,3347000,730,384,346
2977,21,388,3347100,0,0,0
2978,21,388,3347200,1228,611,617
2979,21,388,3347300,446,205,241
2980,21,388,3347400,494,266,228
2981,21,388,3347500,1748,914,834
2982,21,388,3347600,638,340,298
2983,21,388,3347700,782,391,391
2984,21,388,3347800,1227,679,548
2985,21,388,3347900,217,109,108
2986,21,388,3348000,1145,617,528
2987,21,388,3348100,497,227,270
2988,21,388,3348200,480,227,253
2989,21,388,3348300,966,470,496
2990,21,388,3348400,7,5,2
2991,21,388,3348500,559,273,286
2992,21,388,3348600,6511,3198,3313
2993,21,388,3348700,3758,1895,1863
2994,21,388,3348800,1476,755,721
2995,21,388,3348900,6481,3265,3216
2996,21,388,3349000,971,475,496
2997,21,388,3349100,46,20,26
2998,21,388,3349200,1534,808,726
2999,21,388,3349300,851,426,425
3000,21,388,3349400,87,41,46
3001,21,388,3349500,30,18,12
3002,21,388,3349600,0,0,0
3003,21,388,3349700,262,136,126
3004,21,388,3349800,120,53,67
3005,21,388,3349900,238,111,127
3006,21,388,3350000,35,17,18
3007,21,388,3350100,345,173,172
3008,21,388,3350200,506,251,255
3009,21,388,3350300,117,58,59
3010,21,388,3350400,635,314,321
3011,21,388,3350500,33,14,19
3012,21,388,3350600,505,264,241
3013,21,388,3350700,230,108,122
3014,21,388,3350800,624,310,314
3015,21,388,3350900,301,155,146
3016,21,388,3351000,218,113,105
3017,21,388,3351100,899,475,424
3018,21,388,3351200,489,257,232
3019,21,388,3351300,788,408,380
3020,21,388,3351400,482,222,260
3021,21,388,3351500,723,369,354
3022,21,388,3351600,1414,741,673
3023,21,388,3351700,1384,663,721
3024,21,388,3351800,404,186,218
3025,21,388,3351900,1574,765,809
3026,21,388,3352000,3576,1850,1726
3027,21,388,3352100,1166,598,568
3028,21,388,3352200,625,309,316
3029,21,388,3352300,1067,543,524
3030,21,388,3352400,1267,644,623
3031,21,388,3352500,0,0,0
3032,21,388,3352600,927,494,433
3033,21,388,3352700,250,131,119
3034,21,388,3352800,0,0,0
3035,21,388,3352900,3970,1938,2032
3036,21,388,3353000,4905,2426,2479
3037,21,388,3353100,1922,1022,900
3038,21,388,3353200,2005,933,1072
3039,21,388,3353300,3274,1625,1649
3040,21,388,3353400,6531,3308,3223
3041,21,388,3353500,2436,1223,1213
3042,21,388,3353600,2163,1049,1114
3043,21,388,3353700,1307,633,674
3044,21,388,3353800,3868,1893,1975
3045,21,388,3353900,2989,1414,1575
3046,21,388,3354000,2032,1004,1028
3047,21,388,3354100,1838,865,973
3048,21,388,3354200,1611,783,828
3049,21,388,3354300,4820,2479,2341
3050,21,388,3354400,6907,3345,3562
3051,21,388,3354500,475,227,248
3052,21,388,3354600,690,350,340
3053,21,388,3354700,586,297,289
3054,21,388,3354800,0,0,0
3055,21,388,3354900,2743,1472,1271
3056,21,388,3355000,1201,645,556
3057,21,388,3355100,0,0,0
3058,21,388,3355200,1107,586,521
3059,21,388,3355300,2209,1191,1018
3060,21,388,3355400,2906,1468,1438
3061,21,388,3355500,1656,806,850
3062,21,388,3355600,653,345,308
3063,21,388,3355700,1026,515,511
3064,21,388,3355800,886,511,375
3065,21,388,3355900,2291,1176,1115
3066,21,388,3356000,1223,655,568
3067,21,388,3356100,1118,570,548
3068,21,388,3356200,588,295,293
3069,21,388,3356300,1116,550,566
3070,21,388,3356400,3652,1751,1901
3071,21,388,3356500,1853,864,989
3072,21,388,3356600,3273,1567,1706
3073,21,388,3356700,983,471,512
3074,21,388,3356800,3351,1643,1708
3075,21,388,3356900,2305,1074,1231
3076,21,388,3357000,3139,1546,1593
3077,21,388,3357100,2398,1173,1225
3078,21,388,3357200,1176,556,620
3079,21,388,3357300,2007,971,1036
3080,21,388,3357400,865,414,451
3081,21,388,3357500,1955,931,1024
3082,21,388,3357600,80,35,45
3083,21,388,3357700,1744,886,858
3084,21,388,3357800,2741,1182,1559
3085,21,388,3357900,2108,988,1120
3086,21,388,3358000,1287,604,683
3087,21,388,3358100,2426,1219,1207
3088,21,388,3358200,2735,1334,1401
3089,21,388,3358300,828,391,437
3090,21,388,3358400,1505,716,789
3091,21,388,3358500,5454,2649,2805
3092,21,388,3358600,1583,773,810
3093,21,388,3358700,5117,2478,2639
3094,21,388,3358800,642,322,320
3095,21,388,3358900,0,0,0
3096,21,388,3359000,0,0,0
3097,21,388,3359100,0,0,0
3098,21,388,3359200,605,298,307
3099,21,388,3359300,840,422,418
3100,21,388,3359400,1071,491,580
3101,21,388,3359500,731,368,363
3102,21,388,3359600,2560,1220,1340
3103,21,388,3359700,0,0,0
3104,21,388,3359800,15,10,5
3105,21,388,3359900,0,0,0
3106,21,388,3360000,54,29,25
3107,21,388,3360100,23,10,13
3108,21,388,3360200,42,14,28
3109,21,388,3360300,82,41,41
3110,21,388,3360400,33,16,17
3111,21,388,3360500,81,44,37
3112,21,388,3360600,0,0,0
3113,21,388,3360700,63,32,31
3114,21,388,3360800,44,20,24
3115,21,388,3360900,50,26,24
3116,21,388,3361000,22,8,14
3117,21,388,3361100,44,23,21
3118,21,388,3361200,171,88,83
3119,21,388,3361300,122,62,60
3120,21,388,3361400,221,109,112
3121,21,388,3361500,92,52,40
3122,21,388,3361600,45,22,23
3123,21,388,3361700,60,33,27
3124,21,388,3361800,21,7,14
3125,21,388,3361900,54,31,23
3126,21,388,3362000,52,25,27
3127,21,388,3362100,130,73,57
3128,21,388,3362200,155,78,77
3129,21,388,3362300,304,155,149
3130,21,388,3362400,20,10,10
3131,21,388,3362500,0,0,0
3132,21,388,3362600,21,12,9
3133,21,388,3362700,79,43,36
3134,21,388,3362800,117,56,61
3135,21,388,3362900,34,18,16
3136,21,388,3363000,120,69,51
3137,21,388,3363100,147,68,79
3138,21,388,3363200,49,27,22
3139,21,388,3363300,262,140,122
3140,21,388,3363400,257,133,124
3141,21,388,3363500,51,26,25
3142,21,388,3363600,120,60,60
3143,21,388,3363700,118,54,64
3144,21,388,3363800,41,18,23
3145,21,388,3363900,65,35,30
3146,21,388,3364000,0,0,0
3147,21,388,3364100,34,16,18
3148,21,388,3364200,98,48,50
3149,21,388,3364300,160,77,83
3150,21,388,3364400,13,6,7
3151,21,388,3364500,63,34,29
3152,21,388,3364600,0,0,0
3153,21,388,3364700,26,17,9
3154,21,388,3364800,138,63,75
3155,21,388,3364900,83,44,39
3156,21,388,3365000,213,97,116
3157,21,388,3365100,22,11,11
3158,21,388,3365200,94,46,48
3159,21,388,3365300,128,59,69
3160,21,388,3365400,88,48,40
3161,21,388,3365500,119,52,67
3162,21,388,3365600,113,58,55
3163,21,388,3365700,132,72,60
3164,21,388,3365800,1071,580,491
3165,21,388,3365900,35,18,17
3166,21,388,3366000,117,49,68
3167,21,388,3366100,20,11,9
3168,21,388,3366200,45,17,28
3169,21,388,3366300,40,16,24
3170,21,388,3366400,125,62,63
3171,21,388,3366500,126,66,60
3172,21,388,3366600,451,319,132
3173,21,388,3366700,98,46,52
3174,21,388,3366800,176,89,87
3175,21,388,3366900,118,55,63
3176,21,388,3367000,22,11,11
3177,21,388,3367100,0,0,0
3178,21,388,3367200,261,123,138
3179,21,388,3367300,0,0,0
3180,21,388,3367400,129,72,57
3181,21,388,3367500,284,137,147
3182,21,388,3367600,127,60,67
3183,21,388,3367700,125,65,60
3184,21,388,3367800,30,16,14
3185,21,388,3367900,184,85,99
3186,21,388,3368000,79,34,45
3187,21,388,3368100,144,71,73
3188,21,388,3368200,31,17,14
3189,21,388,3368300,36,21,15
3190,21,388,3368400,180,93,87
3191,21,388,3368500,214,97,117
3192,21,388,3368600,50,20,30
3193,21,388,3368700,120,63,57
3194,21,388,3368800,112,60,52
3195,21,388,3368900,0,0,0
3196,21,388,3369000,92,42,50
3197,21,388,3369100,77,32,45
3198,21,388,3369200,129,69,60
3199,21,388,3369300,135,72,63
3200,21,388,3369400,194,103,91
3201,21,388,3369500,400,203,197
3202,21,388,3369600,0,0,0
3203,21,388,3369700,50,27,23
3204,21,388,3369800,48,22,26
3205,21,388,3369900,64,32,32
3206,21,388,3370000,61,32,29
3207,21,388,3370100,119,56,63
3208,21,388,3370200,20,10,10
3209,21,388,3370300,102,54,48
3210,21,388,3370400,49,21,28
3211,21,388,3370500,96,49,47
