,Statecode,Districtcode,VillageCode,Population,Males,Females
0,21,395,4247300,3998,1973,2025
1,21,395,4247400,2677,1305,1372
2,21,395,4247500,3214,1599,1615
3,21,395,4247600,4179,2096,2083
4,21,395,4247700,3406,1729,1677
5,21,395,4247800,881,431,450
6,21,395,4247900,2495,1264,1231
7,21,395,4248000,4297,2149,2148
8,21,395,4248100,3158,1584,1574
9,21,395,4248200,1909,978,931
10,21,395,4248300,627,293,334
11,21,395,4248400,4208,2070,2138
12,21,395,4248500,1486,723,763
13,21,395,4248600,278,137,141
14,21,395,4248700,6643,3304,3339
15,21,395,4248800,1254,622,632
16,21,395,4248900,964,481,483
17,21,395,4249000,3621,1784,1837
18,21,395,4249100,1310,673,637
19,21,395,4249200,1412,688,724
20,21,395,4249300,1108,543,565
21,21,395,4249400,3061,1536,1525
22,21,395,4249500,1739,865,874
23,21,395,4249600,425,225,200
24,21,395,4249700,1115,546,569
25,21,395,4249800,507,241,266
26,21,395,4249900,1659,820,839
27,21,395,4250000,0,0,0
28,21,395,4250100,1744,881,863
29,21,395,4250200,1179,581,598
30,21,395,4250300,1702,830,872
31,21,395,4250400,1358,670,688
32,21,395,4250500,845,419,426
33,21,395,4250600,1342,658,684
34,21,395,4250700,6587,3248,3339
35,21,395,4250800,3469,1743,1726
36,21,395,4250900,1846,961,885
37,21,395,4251000,1773,870,903
38,21,395,4251100,1337,650,687
39,21,395,4251200,1015,514,501
40,21,395,4251300,745,359,386
41,21,395,4251400,374,182,192
42,21,395,4251500,3660,1748,1912
43,21,395,4251600,999,474,525
44,21,395,4251700,2266,1124,1142
45,21,395,4251800,47,20,27
46,21,395,4251900,1633,794,839
47,21,395,4252000,334,168,166
48,21,395,4252100,3122,1570,1552
49,21,395,4252200,1773,885,888
50,21,395,4252300,3867,1957,1910
51,21,395,4252400,4988,2550,2438
52,21,395,4252500,1437,697,740
53,21,395,4252600,3902,1940,1962
54,21,395,4252700,515,256,259
55,21,395,4252800,2486,1220,1266
56,21,395,4252900,2925,1442,1483
57,21,395,4253000,589,300,289
58,21,395,4253100,1825,878,947
59,21,395,4253200,2379,1213,1166
60,21,395,4253300,754,382,372
61,21,395,4253400,1380,680,700
62,21,395,4253500,1186,575,611
63,21,395,4253600,323,165,158
64,21,395,4253700,1464,721,743
65,21,395,4253800,923,443,480
66,21,395,4253900,969,483,486
67,21,395,4254000,4036,1970,2066
68,21,395,4254100,2204,1076,1128
69,21,395,4254200,3138,1558,1580
70,21,395,4254300,1595,782,813
71,21,395,4254400,2314,1145,1169
72,21,395,4254500,1836,934,902
73,21,395,4254600,7655,3860,3795
74,21,395,4254700,483,229,254
75,21,395,4254800,1610,814,796
76,21,395,4254900,2049,1020,1029
77,21,395,4255000,5534,2739,2795
78,21,395,4255100,1178,583,595
79,21,395,4255200,2224,1078,1146
80,21,395,4255300,2409,1200,1209
81,21,395,4255400,2224,1122,1102
82,21,395,4255500,2743,1352,1391
83,21,395,4255600,7482,3688,3794
84,21,395,4255700,0,0,0
85,21,395,4255800,320,153,167
86,21,395,4255900,732,347,385
87,21,395,4256000,417,201,216
88,21,395,4256100,3380,1677,1703
89,21,395,4256200,1059,535,524
90,21,395,4256300,1982,1020,962
91,21,395,4256400,1178,565,613
92,21,395,4256500,1097,548,549
93,21,395,4256600,6013,3135,2878
94,21,395,4256700,1844,919,925
95,21,395,4256800,544,279,265
96,21,395,4256900,558,249,309
97,21,395,4257000,193,96,97
98,21,395,4257100,12,8,4
99,21,395,4257200,808,398,410
100,21,395,4257300,706,332,374
101,21,395,4257400,83,43,40
102,21,395,4257500,504,260,244
103,21,395,4257600,1967,940,1027
104,21,395,4257700,365,187,178
105,21,395,4257800,253,120,133
106,21,395,4257900,1677,837,840
107,21,395,4258000,901,443,458
108,21,395,4258100,307,158,149
109,21,395,4258200,4421,2232,2189
110,21,395,4258300,785,386,399
111,21,395,4258400,1930,1026,904
112,21,395,4258500,1149,576,573
113,21,395,4258600,966,472,494
114,21,395,4258700,1889,963,926
115,21,395,4258800,1134,597,537
116,21,395,4258900,1794,897,897
117,21,395,4259000,3258,1616,1642
118,21,395,4259100,1019,506,513
119,21,395,4259200,2292,1154,1138
120,21,395,4259300,1442,738,704
121,21,395,4259400,819,411,408
122,21,395,4259500,1037,531,506
123,21,395,4259600,1261,664,597
124,21,395,4259700,1938,1008,930
125,21,395,4259800,1958,1014,944
126,21,395,4259900,1876,947,929
127,21,395,4260000,1668,830,838
128,21,395,4260100,1265,604,661
129,21,395,4260200,1101,558,543
130,21,395,4260300,1489,751,738
131,21,395,4260400,732,370,362
132,21,395,4260500,692,332,360
133,21,395,4260600,1377,708,669
134,21,395,4260700,4714,2507,2207
135,21,395,4260800,1961,978,983
136,21,395,4260900,1361,689,672
137,21,395,4261000,2628,1360,1268
138,21,395,4261100,3690,1859,1831
139,21,395,4261200,2824,1430,1394
140,21,395,4261300,2962,1524,1438
141,21,395,4261400,2093,1066,1027
142,21,395,4261500,605,302,303
143,21,395,4261600,2485,1259,1226
144,21,395,4261700,8466,4222,4244
145,21,395,4261800,5375,2704,2671
146,21,395,4261900,1956,993,963
147,21,395,4262000,3592,1825,1767
148,21,395,4262100,1000,516,484
149,21,395,4262200,1788,897,891
150,21,395,4262300,2175,1103,1072
151,21,395,4262400,1535,761,774
152,21,395,4262500,1587,793,794
153,21,395,4262600,3052,1577,1475
154,21,395,4262700,2268,1155,1113
155,21,395,4262800,1125,567,558
156,21,395,4262900,1389,702,687
157,21,395,4263000,1120,559,561
158,21,395,4263100,732,390,342
159,21,395,4263200,2828,1457,1371
160,21,395,4263300,4973,2504,2469
161,21,395,4263400,1086,540,546
162,21,395,4263500,3584,1800,1784
163,21,395,4263600,1434,700,734
164,21,395,4263700,2181,1086,1095
165,21,395,4263800,2972,1445,1527
166,21,395,4263900,1302,643,659
167,21,395,4264000,3826,1870,1956
168,21,395,4264100,2573,1256,1317
169,21,395,4264200,546,266,280
170,21,395,4264300,1531,777,754
171,21,395,4264400,3620,1794,1826
172,21,395,4264500,381,188,193
173,21,395,4264600,455,243,212
174,21,395,4264700,942,447,495
175,21,395,4264800,1087,560,527
176,21,395,4264900,1606,821,785
177,21,395,4265000,881,422,459
178,21,395,4265100,1468,731,737
179,21,395,4265200,261,125,136
180,21,395,4265300,1687,840,847
181,21,395,4265400,0,0,0
182,21,395,4265500,740,370,370
183,21,395,4265600,644,300,344
184,21,395,4265700,773,376,397
185,21,395,4265800,465,224,241
186,21,395,4265900,842,427,415
187,21,395,4266000,3807,1861,1946
188,21,395,4266100,1087,551,536
189,21,395,4266200,771,381,390
190,21,395,4266300,845,436,409
191,21,395,4266400,1294,633,661
192,21,395,4266500,648,317,331
193,21,395,4266600,2348,1194,1154
194,21,395,4266700,1234,595,639
195,21,395,4266800,881,433,448
196,21,395,4266900,614,305,309
197,21,395,4267000,176,96,80
198,21,395,4267100,639,325,314
199,21,395,4267200,1846,953,893
200,21,395,4267300,1004,492,512
201,21,395,4267400,1458,737,721
202,21,395,4267500,790,368,422
203,21,395,4267600,694,347,347
204,21,395,4267700,1375,672,703
205,21,395,4267800,799,405,394
206,21,395,4267900,1954,975,979
207,21,395,4268000,1684,829,855
208,21,395,4268100,1123,530,593
209,21,395,4268200,813,410,403
210,21,395,4268300,1015,494,521
211,21,395,4268400,2945,1450,1495
212,21,395,4268500,828,416,412
213,21,395,4268600,1405,672,733
214,21,395,4268700,314,151,163
215,21,395,4268800,2349,1147,1202
216,21,395,4268900,1142,569,573
217,21,395,4269000,249,113,136
218,21,395,4269100,1231,611,620
219,21,395,4269200,1554,756,798
220,21,395,4269300,569,287,282
221,21,395,4269400,1476,694,782
222,21,395,4269500,1861,909,952
223,21,395,4269600,1240,619,621
224,21,395,4269700,348,161,187
225,21,395,4269800,657,330,327
226,21,395,4269900,390,209,181
227,21,395,4270000,466,220,246
228,21,395,4270100,938,465,473
229,21,395,4270200,240,112,128
230,21,395,4270300,2313,1146,1167
231,21,395,4270400,1847,923,924
232,21,395,4270500,477,235,242
233,21,395,4270600,3334,1689,1645
234,21,395,4270700,2046,1016,1030
235,21,395,4270800,1079,525,554
236,21,395,4270900,1799,901,898
237,21,395,4271000,1273,657,616
238,21,395,4271100,3122,1580,1542
239,21,395,4271200,424,216,208
240,21,395,4271300,1376,681,695
241,21,395,4271400,181,96,85
242,21,395,4271500,509,262,247
243,21,395,4271600,477,250,227
244,21,395,4271700,242,135,107
245,21,395,4271800,127,63,64
246,21,395,4271900,491,245,246
247,21,395,4272000,193,85,108
248,21,395,4272100,2268,1194,1074
249,21,395,4272200,3080,1518,1562
250,21,395,4272300,1930,976,954
251,21,395,4272400,0,0,0
252,21,395,4272500,1385,679,706
253,21,395,4272600,894,425,469
254,21,395,4272700,205,99,106
255,21,395,4272800,174,82,92
256,21,395,4272900,362,166,196
257,21,395,4273000,489,224,265
258,21,395,4273100,40,20,20
259,21,395,4273200,457,216,241
260,21,395,4273300,420,196,224
261,21,395,4273400,92,42,50
262,21,395,4273500,73,35,38
263,21,395,4273600,1278,624,654
264,21,395,4273700,893,435,458
265,21,395,4273800,229,108,121
266,21,395,4273900,887,447,440
267,21,395,4274000,68,32,36
268,21,395,4274100,1246,588,658
269,21,395,4274200,2006,1021,985
270,21,395,4274300,2395,1209,1186
271,21,395,4274400,874,425,449
272,21,395,4274500,1363,692,671
273,21,395,4274600,1830,863,967
274,21,395,4274700,243,111,132
275,21,395,4274800,1429,696,733
276,21,395,4274900,0,0,0
277,21,395,4275000,771,377,394
278,21,395,4275100,716,342,374
279,21,395,4275200,1036,507,529
280,21,395,4275300,1442,732,710
281,21,395,4275400,1014,506,508
282,21,395,4275500,865,447,418
283,21,395,4275600,0,0,0
284,21,395,4275700,777,398,379
285,21,395,4275800,1219,607,612
286,21,395,4275900,446,235,211
287,21,395,4276000,563,281,282
288,21,395,4276100,308,157,151
289,21,395,4276200,643,308,335
290,21,395,4276300,1799,903,896
291,21,395,4276400,2479,1177,1302
292,21,395,4276500,955,466,489
293,21,395,4276600,2008,1019,989
294,21,395,4276700,1484,769,715
295,21,395,4276800,0,0,0
296,21,395,4276900,2251,1148,1103
297,21,395,4277000,2373,1178,1195
298,21,395,4277100,1252,596,656
299,21,395,4277200,684,342,342
300,21,395,4277300,1721,845,876
301,21,395,4277400,1944,962,982
302,21,395,4277500,1244,639,605
303,21,395,4277600,1272,613,659
304,21,395,4277700,2396,1220,1176
305,21,395,4277800,1148,566,582
306,21,395,4277900,785,395,390
307,21,395,4278000,952,470,482
308,21,395,4278100,636,320,316
309,21,395,4278200,477,226,251
310,21,395,4278300,24,10,14
311,21,395,4278400,370,174,196
312,21,395,4278500,769,380,389
313,21,395,4278600,2825,1501,1324
314,21,395,4278700,1578,804,774
315,21,395,4278800,867,450,417
316,21,395,4278900,925,465,460
317,21,395,4279000,1119,569,550
318,21,395,4279100,948,499,449
319,21,395,4279200,1446,729,717
320,21,395,4279300,1419,710,709
321,21,395,4279400,38,17,21
322,21,395,4279500,454,235,219
323,21,395,4279600,262,125,137
324,21,395,4279700,618,284,334
325,21,395,4279800,1107,559,548
326,21,395,4279900,1583,782,801
327,21,395,4280000,0,0,0
328,21,395,4280100,1825,894,931
329,21,395,4280200,804,403,401
330,21,395,4280300,2567,1261,1306
331,21,395,4280400,1063,531,532
332,21,395,4280500,1076,523,553
333,21,395,4280600,785,382,403
334,21,395,4280700,1008,491,517
335,21,395,4280800,524,269,255
336,21,395,4280900,679,337,342
337,21,395,4281000,351,176,175
338,21,395,4281100,82,42,40
339,21,395,4281200,204,94,110
340,21,395,4281300,151,80,71
341,21,395,4281400,375,179,196
342,21,395,4281500,370,221,149
343,21,395,4281600,2096,1058,1038
344,21,395,4281700,550,286,264
345,21,395,4281800,0,0,0
346,21,395,4281900,838,432,406
347,21,395,4282000,73,38,35
348,21,395,4282100,2222,1087,1135
349,21,395,4282200,149,88,61
350,21,395,4282300,399,197,202
351,21,395,4282400,1702,828,874
352,21,395,4282500,1417,711,706
353,21,395,4282600,1337,655,682
354,21,395,4282700,2097,1055,1042
355,21,395,4282800,778,372,406
356,21,395,4282900,938,479,459
357,21,395,4283000,866,418,448
358,21,395,4283100,872,414,458
359,21,395,4283200,765,372,393
360,21,395,4283300,470,225,245
361,21,395,4283400,307,152,155
362,21,395,4283500,1398,704,694
363,21,395,4283600,765,399,366
364,21,395,4283700,38,23,15
365,21,395,4283800,721,354,367
366,21,395,4283900,283,146,137
367,21,395,4284000,798,386,412
368,21,395,4284100,567,299,268
369,21,395,4284200,315,144,171
370,21,395,4284300,885,454,431
371,21,395,4284400,682,354,328
372,21,395,4284500,956,464,492
373,21,395,4284600,3273,1632,1641
374,21,395,4284700,1097,539,558
375,21,395,4284800,258,132,126
376,21,395,4284900,714,376,338
377,21,395,4285000,279,132,147
378,21,395,4285100,611,328,283
379,21,395,4285200,0,0,0
380,21,395,4285300,0,0,0
381,21,395,4285400,313,157,156
382,21,395,4285500,685,344,341
383,21,395,4285600,498,242,256
384,21,395,4285700,367,168,199
385,21,395,4285800,714,370,344
386,21,395,4285900,0,0,0
387,21,395,4286000,472,220,252
388,21,395,4286100,967,465,502
389,21,395,4286200,542,273,269
390,21,395,4286300,388,176,212
391,21,395,4286400,466,226,240
392,21,395,4286500,169,92,77
393,21,395,4286600,65,35,30
394,21,395,4286700,604,290,314
395,21,395,4286800,172,85,87
396,21,395,4286900,84,41,43
397,21,395,4287000,62,31,31
398,21,395,4287100,143,68,75
399,21,395,4287200,136,58,78
400,21,395,4287300,60,23,37
401,21,395,4287400,38,24,14
402,21,395,4287500,13,8,5
403,21,395,4287600,0,0,0
404,21,395,4287700,101,49,52
405,21,395,4287800,195,106,89
406,21,395,4287900,142,71,71
407,21,395,4288000,0,0,0
408,21,395,4288100,146,65,81
409,21,395,4288200,151,67,84
410,21,395,4288300,298,144,154
411,21,395,4288400,134,63,71
412,21,395,4288500,183,82,101
413,21,395,4288600,157,80,77
414,21,395,4288700,0,0,0
415,21,395,4288800,555,301,254
416,21,395,4288900,0,0,0
417,21,395,4289000,0,0,0
418,21,395,4289100,301,153,148
419,21,395,4289200,154,82,72
420,21,395,4289300,112,62,50
421,21,395,4289400,949,465,484
422,21,395,4289500,575,271,304
423,21,395,4289600,605,309,296
424,21,395,4289700,372,174,198
425,21,395,4289800,3140,1609,1531
426,21,395,4289900,992,492,500
427,21,395,4290000,465,236,229
428,21,395,4290100,3369,1779,1590
429,21,395,4290200,1269,639,630
430,21,395,4290300,739,374,365
431,21,395,4290400,956,462,494
432,21,395,4290500,236,120,116
433,21,395,4290600,1163,555,608
434,21,395,4290700,1402,721,681
435,21,395,4290800,687,344,343
436,21,395,4290900,881,448,433
437,21,395,4291000,348,174,174
438,21,395,4291100,745,382,363
439,21,395,4291200,1095,540,555
440,21,395,4291300,756,386,370
441,21,395,4291400,1083,558,525
442,21,395,4291500,915,458,457
443,21,395,4291600,372,182,190
444,21,395,4291700,752,347,405
445,21,395,4291800,1086,543,543
446,21,395,4291900,851,425,426
447,21,395,4292000,196,80,116
448,21,395,4292100,850,428,422
449,21,395,4292200,1027,521,506
450,21,395,4292300,353,180,173
451,21,395,4292400,130,60,70
452,21,395,4292500,989,499,490
453,21,395,4292600,78,35,43
454,21,395,4292700,94,48,46
455,21,395,4292800,240,116,124
456,21,395,4292900,900,454,446
457,21,395,4293000,636,316,320
458,21,395,4293100,450,225,225
459,21,395,4293200,863,443,420
460,21,395,4293300,558,275,283
461,21,395,4293400,173,88,85
462,21,395,4293500,499,236,263
463,21,395,4293600,403,213,190
464,21,395,4293700,974,494,480
465,21,395,4293800,0,0,0
466,21,395,4293900,559,278,281
467,21,395,4294000,841,439,402
468,21,395,4294100,0,0,0
469,21,395,4294200,160,78,82
470,21,395,4294300,10,4,6
471,21,395,4294400,0,0,0
472,21,395,4294500,276,130,146
473,21,395,4294600,102,55,47
474,21,395,4294700,130,57,73
475,21,395,4294800,128,62,66
476,21,395,4294900,203,98,105
477,21,395,4295000,101,49,52
478,21,395,4295100,169,93,76
479,21,395,4295200,80,39,41
480,21,395,4295300,210,107,103
481,21,395,4295400,31,11,20
482,21,395,4295500,20,10,10
483,21,395,4295600,23,13,10
484,21,395,4295700,71,34,37
485,21,395,4295800,247,125,122
486,21,395,4295900,0,0,0
487,21,395,4296000,111,62,49
488,21,395,4296100,35,17,18
489,21,395,4296200,0,0,0
490,21,395,4296300,60,27,33
491,21,395,4296400,32,16,16
492,21,395,4296500,190,98,92
493,21,395,4296600,91,43,48
494,21,395,4296700,41,16,25
495,21,395,4296800,196,96,100
496,21,395,4296900,54,26,28
497,21,395,4297000,231,106,125
498,21,395,4297100,109,48,61
499,21,395,4297200,448,210,238
500,21,395,4297300,455,224,231
501,21,395,4297400,0,0,0
502,21,395,4297500,234,109,125
503,21,395,4297600,0,0,0
504,21,395,4297700,71,42,29
505,21,395,4297800,72,38,34
506,21,395,4297900,8,3,5
507,21,395,4298000,92,42,50
508,21,395,4298100,57,32,25
509,21,395,4298200,190,92,98
510,21,395,4298300,64,33,31
511,21,395,4298400,0,0,0
512,21,395,4298500,0,0,0
513,21,395,4298600,86,43,43
514,21,395,4298700,99,54,45
515,21,395,4298800,115,62,53
516,21,395,4298900,204,93,111
517,21,395,4299000,294,145,149
518,21,395,4299100,119,55,64
519,21,395,4299200,0,0,0
520,21,395,4299300,299,158,141
521,21,395,4299400,4,1,3
522,21,395,4299500,78,38,40
523,21,395,4299600,668,337,331
524,21,395,4299700,969,506,463
525,21,395,4299800,206,98,108
526,21,395,4299900,324,182,142
527,21,395,4300000,737,390,347
528,21,395,4300100,463,240,223
529,21,395,4300200,181,98,83
530,21,395,4300300,614,299,315
531,21,395,4300400,308,149,159
532,21,395,4300500,581,293,288
533,21,395,4300600,321,143,178
534,21,395,4300700,291,136,155
535,21,395,4300800,47,19,28
536,21,395,4300900,63,27,36
537,21,395,4301000,596,285,311
538,21,395,4301100,151,82,69
539,21,395,4301200,351,165,186
540,21,395,4301300,629,321,308
541,21,395,4301400,299,152,147
542,21,395,4301500,785,382,403
543,21,395,4301600,313,140,173
544,21,395,4301700,206,101,105
545,21,395,4301800,199,113,86
546,21,395,4301900,837,411,426
547,21,395,4302000,125,58,67
548,21,395,4302100,50,20,30
549,21,395,4302200,98,49,49
550,21,395,4302300,0,0,0
551,21,395,4302400,85,49,36
552,21,395,4302500,58,28,30
553,21,395,4302600,71,34,37
554,21,395,4302700,82,38,44
555,21,395,4302800,60,34,26
556,21,395,4302900,299,150,149
557,21,395,4303000,329,166,163
558,21,395,4303100,16,9,7
559,21,395,4303200,208,92,116
560,21,395,4303300,154,77,77
561,21,395,4303400,0,0,0
562,21,395,4303500,234,113,121
563,21,395,4303600,269,143,126
564,21,395,4303700,82,43,39
565,21,395,4303800,0,0,0
566,21,395,4303900,284,146,138
567,21,395,4304000,18,11,7
568,21,395,4304100,233,116,117
569,21,395,4304200,451,212,239
570,21,395,4304300,670,336,334
571,21,395,4304400,239,113,126
572,21,395,4304500,235,116,119
573,21,395,4304600,376,180,196
574,21,395,4304700,596,284,312
575,21,395,4304800,1234,600,634
576,21,395,4304900,78,42,36
577,21,395,4305000,27,19,8
578,21,395,4305100,82,48,34
579,21,395,4305200,161,77,84
580,21,395,4305300,121,55,66
581,21,395,4305400,5,3,2
582,21,395,4305500,508,241,267
583,21,395,4305600,112,50,62
584,21,395,4305700,104,52,52
585,21,395,4305800,88,41,47
586,21,395,4305900,174,84,90
587,21,395,4306000,529,256,273
588,21,395,4306100,142,67,75
589,21,395,4306200,84,42,42
590,21,395,4306300,26,17,9
591,21,395,4306400,48,20,28
592,21,395,4306500,119,64,55
593,21,395,4306600,137,73,64
594,21,395,4306700,115,57,58
595,21,395,4306800,65,32,33
596,21,395,4306900,48,26,22
597,21,395,4307000,234,102,132
598,21,395,4307100,406,210,196
599,21,395,4307200,0,0,0
600,21,395,4307300,164,75,89
601,21,395,4307400,137,69,68
602,21,395,4307500,120,63,57
603,21,395,4307600,353,180,173
604,21,395,4307700,117,48,69
605,21,395,4307800,158,67,91
606,21,395,4307900,0,0,0
607,21,395,4308000,69,35,34
608,21,395,4308100,60,27,33
609,21,395,4308200,55,25,30
610,21,395,4308300,340,167,173
611,21,395,4308400,31,16,15
612,21,395,4308500,43,17,26
613,21,395,4308600,240,125,115
614,21,395,4308700,260,121,139
615,21,395,4308800,0,0,0
616,21,395,4308900,1289,627,662
617,21,395,4309000,777,389,388
618,21,395,4309100,2272,1148,1124
619,21,395,4309200,2460,1224,1236
620,21,395,4309300,1985,1023,962
621,21,395,4309400,867,439,428
622,21,395,4309500,679,347,332
623,21,395,4309600,291,149,142
624,21,395,4309700,386,205,181
625,21,395,4309800,1873,989,884
626,21,395,4309900,402,213,189
627,21,395,4310000,751,370,381
628,21,395,4310100,2686,1358,1328
629,21,395,4310200,456,240,216
630,21,395,4310300,398,187,211
631,21,395,4310400,448,227,221
632,21,395,4310500,864,432,432
633,21,395,4310600,418,213,205
634,21,395,4310700,1949,952,997
635,21,395,4310800,1758,849,909
636,21,395,4310900,870,427,443
637,21,395,4311000,911,470,441
638,21,395,4311100,655,342,313
639,21,395,4311200,618,329,289
640,21,395,4311300,464,227,237
641,21,395,4311400,760,382,378
642,21,395,4311500,1527,771,756
643,21,395,4311600,328,159,169
644,21,395,4311700,337,175,162
645,21,395,4311800,1769,880,889
646,21,395,4311900,2140,1043,1097
647,21,395,4312000,812,395,417
648,21,395,4312100,811,407,404
649,21,395,4312200,3117,1563,1554
650,21,395,4312300,0,0,0
651,21,395,4312400,2258,1145,1113
652,21,395,4312500,870,441,429
653,21,395,4312600,0,0,0
654,21,395,4312700,1029,516,513
655,21,395,4312800,747,370,377
656,21,395,4312900,0,0,0
657,21,395,4313000,643,314,329
658,21,395,4313100,94,46,48
659,21,395,4313200,264,130,134
660,21,395,4313300,412,206,206
661,21,395,4313400,218,102,116
662,21,395,4313500,511,251,260
663,21,395,4313600,611,294,317
664,21,395,4313700,2096,1041,1055
665,21,395,4313800,292,144,148
666,21,395,4313900,927,465,462
667,21,395,4314000,599,295,304
668,21,395,4314100,851,416,435
669,21,395,4314200,903,441,462
670,21,395,4314300,196,94,102
671,21,395,4314400,1280,666,614
672,21,395,4314500,1187,591,596
673,21,395,4314600,1662,832,830
674,21,395,4314700,870,412,458
675,21,395,4314800,2208,1138,1070
676,21,395,4314900,771,389,382
677,21,395,4315000,1283,643,640
678,21,395,4315100,1483,781,702
679,21,395,4315200,762,376,386
680,21,395,4315300,0,0,0
681,21,395,4315400,3845,1930,1915
682,21,395,4315500,1334,673,661
683,21,395,4315600,0,0,0
684,21,395,4315700,2437,1185,1252
685,21,395,4315800,707,344,363
686,21,395,4315900,2155,1058,1097
687,21,395,4316000,2560,1305,1255
688,21,395,4316100,1261,645,616
689,21,395,4316200,91,47,44
690,21,395,4316300,2286,1118,1168
691,21,395,4316400,287,132,155
692,21,395,4316500,1004,494,510
693,21,395,4316600,443,226,217
694,21,395,4316700,532,273,259
695,21,395,4316800,539,256,283
696,21,395,4316900,532,271,261
697,21,395,4317000,1979,991,988
698,21,395,4317100,1386,701,685
699,21,395,4317200,3088,1592,1496
700,21,395,4317300,1397,677,720
701,21,395,4317400,1147,605,542
702,21,395,4317500,1005,488,517
703,21,395,4317600,0,0,0
704,21,395,4317700,486,241,245
705,21,395,4317800,1977,1007,970
706,21,395,4317900,1513,788,725
707,21,395,4318000,552,277,275
708,21,395,4318100,942,458,484
709,21,395,4318200,1142,544,598
710,21,395,4318300,1502,768,734
711,21,395,4318400,643,315,328
712,21,395,4318500,1524,784,740
713,21,395,4318600,662,331,331
714,21,395,4318700,548,270,278
715,21,395,4318800,1729,852,877
716,21,395,4318900,1941,949,992
717,21,395,4319000,726,392,334
718,21,395,4319100,747,375,372
719,21,395,4319200,680,336,344
720,21,395,4319300,1412,685,727
721,21,395,4319400,1729,856,873
722,21,395,4319500,0,0,0
723,21,395,4319600,391,193,198
724,21,395,4319700,765,384,381
725,21,395,4319800,2398,1200,1198
726,21,395,4319900,432,220,212
727,21,395,4320000,973,473,500
728,21,395,4320100,1476,708,768
729,21,395,4320200,0,0,0
730,21,395,4320300,1229,627,602
731,21,395,4320400,1740,841,899
732,21,395,4320500,232,100,132
733,21,395,4320600,1298,666,632
734,21,395,4320700,4636,2348,2288
735,21,395,4320800,774,383,391
736,21,395,4320900,2214,1067,1147
737,21,395,4321000,0,0,0
738,21,395,4321100,702,322,380
739,21,395,4321200,1586,803,783
740,21,395,4321300,1261,648,613
741,21,395,4321400,2172,1060,1112
742,21,395,4321500,1116,536,580
743,21,395,4321600,530,261,269
744,21,395,4321700,443,236,207
745,21,395,4321800,1748,900,848
746,21,395,4321900,544,277,267
747,21,395,4322000,511,269,242
748,21,395,4322100,499,251,248
749,21,395,4322200,763,384,379
750,21,395,4322300,5,2,3
751,21,395,4322400,912,442,470
752,21,395,4322500,1736,886,850
753,21,395,4322600,1480,739,741
754,21,395,4322700,893,440,453
755,21,395,4322800,1295,647,648
756,21,395,4322900,1507,731,776
757,21,395,4323000,685,354,331
758,21,395,4323100,915,450,465
759,21,395,4323200,1147,558,589
760,21,395,4323300,2129,1041,1088
761,21,395,4323400,3428,1779,1649
762,21,395,4323500,0,0,0
763,21,395,4323600,2714,1372,1342
764,21,395,4323700,688,340,348
765,21,395,4323800,915,454,461
766,21,395,4323900,82,49,33
767,21,395,4324000,1137,560,577
768,21,395,4324100,1755,882,873
769,21,395,4324200,0,0,0
770,21,395,4324300,1155,583,572
771,21,395,4324400,732,377,355
772,21,395,4324500,0,0,0
773,21,395,4324600,1747,852,895
774,21,395,4324700,386,195,191
775,21,395,4324800,2706,1384,1322
776,21,395,4324900,1205,605,600
777,21,395,4325000,885,418,467
778,21,395,4325100,684,328,356
779,21,395,4325200,2485,1231,1254
780,21,395,4325300,359,182,177
781,21,395,4325400,828,406,422
782,21,395,4325500,2144,1056,1088
783,21,395,4325600,699,336,363
784,21,395,4325700,325,161,164
785,21,395,4325800,1175,592,583
786,21,395,4325900,960,514,446
787,21,395,4326000,417,217,200
788,21,395,4326100,942,480,462
789,21,395,4326200,381,180,201
790,21,395,4326300,1235,624,611
791,21,395,4326400,340,173,167
792,21,395,4326500,1853,905,948
793,21,395,4326600,1679,873,806
794,21,395,4326700,486,245,241
795,21,395,4326800,863,419,444
796,21,395,4326900,251,128,123
797,21,395,4327000,1056,540,516
798,21,395,4327100,1571,793,778
799,21,395,4327200,1568,813,755
800,21,395,4327300,1801,925,876
801,21,395,4327400,3791,1909,1882
802,21,395,4327500,736,368,368
803,21,395,4327600,83,41,42
804,21,395,4327700,887,454,433
805,21,395,4327800,1169,595,574
806,21,395,4327900,485,251,234
807,21,395,4328000,0,0,0
808,21,395,4328100,523,261,262
809,21,395,4328200,372,188,184
810,21,395,4328300,717,355,362
811,21,395,4328400,269,123,146
812,21,395,4328500,286,144,142
813,21,395,4328600,249,115,134
814,21,395,4328700,621,306,315
815,21,395,4328800,697,348,349
816,21,395,4328900,129,62,67
817,21,395,4329000,405,201,204
818,21,395,4329100,184,84,100
819,21,395,4329200,40,23,17
820,21,395,4329300,362,198,164
821,21,395,4329400,294,146,148
822,21,395,4329500,286,146,140
823,21,395,4329600,67,31,36
824,21,395,4329700,76,35,41
825,21,395,4329800,10,3,7
826,21,395,4329900,966,538,428
827,21,395,4330000,463,235,228
828,21,395,4330100,533,250,283
829,21,395,4330200,281,136,145
830,21,395,4330300,849,410,439
831,21,395,4330400,247,115,132
832,21,395,4330500,166,83,83
833,21,395,4330600,32,23,9
834,21,395,4330700,161,73,88
835,21,395,4330800,107,58,49
836,21,395,4330900,397,203,194
837,21,395,4331000,1133,640,493
838,21,395,4331100,1446,738,708
839,21,395,4331200,769,373,396
840,21,395,4331300,1796,945,851
841,21,395,4331400,198,98,100
842,21,395,4331500,2343,1168,1175
843,21,395,4331600,412,206,206
844,21,395,4331700,276,129,147
845,21,395,4331800,218,94,124
846,21,395,4331900,347,174,173
847,21,395,4332000,1120,573,547
848,21,395,4332100,784,372,412
849,21,395,4332200,464,253,211
850,21,395,4332300,52,24,28
851,21,395,4332400,793,399,394
852,21,395,4332500,157,86,71
853,21,395,4332600,372,175,197
854,21,395,4332700,1594,767,827
855,21,395,4332800,0,0,0
856,21,395,4332900,566,261,305
857,21,395,4333000,328,172,156
858,21,395,4333100,905,459,446
859,21,395,4333200,752,367,385
860,21,395,4333300,879,431,448
861,21,395,4333400,416,203,213
862,21,395,4333500,167,84,83
863,21,395,4333600,560,254,306
864,21,395,4333700,337,149,188
865,21,395,4333800,558,270,288
866,21,395,4333900,559,291,268
867,21,395,4334000,2058,974,1084
868,21,395,4334100,684,330,354
869,21,395,4334200,201,100,101
870,21,395,4334300,603,306,297
871,21,395,4334400,199,93,106
872,21,395,4334500,336,174,162
873,21,395,4334600,307,161,146
874,21,395,4334700,279,132,147
875,21,395,4334800,494,241,253
876,21,395,4334900,619,295,324
877,21,395,4335000,1370,600,770
878,21,395,4335100,334,174,160
879,21,395,4335200,894,455,439
880,21,395,4335300,944,514,430
881,21,395,4335400,582,281,301
882,21,395,4335500,685,323,362
883,21,395,4335600,287,144,143
884,21,395,4335700,249,121,128
885,21,395,4335800,231,119,112
886,21,395,4335900,0,0,0
887,21,395,4336000,208,111,97
888,21,395,4336100,0,0,0
889,21,395,4336200,1003,502,501
890,21,395,4336300,0,0,0
891,21,395,4336400,84,43,41
892,21,395,4336500,432,209,223
893,21,395,4336600,120,65,55
894,21,395,4336700,152,76,76
895,21,395,4336800,90,52,38
896,21,395,4336900,100,41,59
897,21,395,4337000,179,90,89
898,21,395,4337100,560,258,302
899,21,395,4337200,57,26,31
900,21,395,4337300,270,135,135
901,21,395,4337400,195,93,102
902,21,395,4337500,190,83,107
903,21,395,4337600,43,23,20
904,21,395,4337700,249,112,137
905,21,395,4337800,46,24,22
906,21,395,4337900,195,82,113
907,21,395,4338000,265,121,144
908,21,395,4338100,624,292,332
909,21,395,4338200,154,80,74
910,21,395,4338300,142,73,69
911,21,395,4338400,271,145,126
912,21,395,4338500,620,302,318
913,21,395,4338600,679,325,354
914,21,395,4338700,381,201,180
915,21,395,4338800,181,99,82
916,21,395,4338900,276,149,127
917,21,395,4339000,189,96,93
918,21,395,4339100,64,31,33
919,21,395,4339200,350,179,171
920,21,395,4339300,710,355,355
921,21,395,4339400,260,128,132
922,21,395,4339500,345,169,176
923,21,395,4339600,189,104,85
924,21,395,4339700,161,90,71
925,21,395,4339800,418,216,202
926,21,395,4339900,801,406,395
927,21,395,4340000,134,62,72
928,21,395,4340100,85,52,33
929,21,395,4340200,1687,855,832
930,21,395,4340300,539,266,273
931,21,395,4340400,11,5,6
932,21,395,4340500,294,143,151
933,21,395,4340600,258,130,128
934,21,395,4340700,58,32,26
935,21,395,4340800,82,47,35
936,21,395,4340900,117,60,57
937,21,395,4341000,100,52,48
938,21,395,4341100,27,11,16
939,21,395,4341200,26,13,13
940,21,395,4341300,19,8,11
941,21,395,4341400,27,12,15
942,21,395,4341500,121,56,65
943,21,395,4341600,160,73,87
944,21,395,4341700,340,173,167
945,21,395,4341800,102,48,54
946,21,395,4341900,183,91,92
947,21,395,4342000,142,71,71
948,21,395,4342100,56,28,28
949,21,395,4342200,152,73,79
950,21,395,4342300,99,47,52
951,21,395,4342400,121,52,69
952,21,395,4342500,93,47,46
953,21,395,4342600,77,35,42
954,21,395,4342700,540,278,262
955,21,395,4342800,494,239,255
956,21,395,4342900,931,466,465
957,21,395,4343000,2379,1209,1170
958,21,395,4343100,225,113,112
959,21,395,4343200,822,407,415
960,21,395,4343300,1366,670,696
961,21,395,4343400,654,325,329
962,21,395,4343500,336,161,175
963,21,395,4343600,293,143,150
964,21,395,4343700,999,471,528
965,21,395,4343800,338,167,171
966,21,395,4343900,149,71,78
967,21,395,4344000,428,206,222
968,21,395,4344100,158,78,80
969,21,395,4344200,725,345,380
970,21,395,4344300,310,161,149
971,21,395,4344400,696,365,331
972,21,395,4344500,314,159,155
973,21,395,4344600,1535,767,768
974,21,395,4344700,1429,752,677
975,21,395,4344800,1110,589,521
976,21,395,4344900,2268,1192,1076
977,21,395,4345000,3614,1781,1833
978,21,395,4345100,926,462,464
979,21,395,4345200,1149,590,559
980,21,395,4345300,1193,584,609
981,21,395,4345400,664,347,317
982,21,395,4345500,1134,539,595
983,21,395,4345600,1442,723,719
984,21,395,4345700,524,250,274
985,21,395,4345800,208,102,106
986,21,395,4345900,1898,955,943
987,21,395,4346000,302,165,137
988,21,395,4346100,226,109,117
989,21,395,4346200,465,231,234
990,21,395,4346300,187,102,85
991,21,395,4346400,293,144,149
992,21,395,4346500,172,76,96
993,21,395,4346600,91,38,53
994,21,395,4346700,309,150,159
995,21,395,4346800,668,336,332
996,21,395,4346900,401,210,191
997,21,395,4347000,432,210,222
998,21,395,4347100,368,184,184
999,21,395,4347200,321,150,171
1000,21,395,4347300,313,157,156
1001,21,395,4347400,123,60,63
1002,21,395,4347500,696,331,365
1003,21,395,4347600,487,239,248
1004,21,395,4347700,494,243,251
1005,21,395,4347800,332,176,156
1006,21,395,4347900,524,256,268
1007,21,395,4348000,1264,657,607
1008,21,395,4348100,1060,531,529
1009,21,395,4348200,2337,1187,1150
1010,21,395,4348300,2846,1446,1400
1011,21,395,4348400,1688,882,806
1012,21,395,4348500,2355,1185,1170
1013,21,395,4348600,1093,542,551
1014,21,395,4348700,567,285,282
1015,21,395,4348800,1481,753,728
1016,21,395,4348900,714,331,383
1017,21,395,4349000,983,498,485
1018,21,395,4349100,1152,575,577
1019,21,395,4349200,677,336,341
1020,21,395,4349300,841,419,422
1021,21,395,4349400,305,154,151
1022,21,395,4349500,2041,988,1053
1023,21,395,4349600,674,317,357
1024,21,395,4349700,881,434,447
1025,21,395,4349800,92,46,46
1026,21,395,4349900,124,56,68
1027,21,395,4350000,231,123,108
1028,21,395,4350100,2231,1093,1138
1029,21,395,4350200,218,161,57
1030,21,395,4350300,0,0,0
1031,21,395,4350400,182,91,91
1032,21,395,4350500,0,0,0
1033,21,395,4350600,1101,539,562
1034,21,395,4350700,138,73,65
1035,21,395,4350800,0,0,0
1036,21,395,4350900,137,68,69
1037,21,395,4351000,144,68,76
1038,21,395,4351100,127,63,64
1039,21,395,4351200,166,77,89
1040,21,395,4351300,146,77,69
1041,21,395,4351400,216,100,116
1042,21,395,4351500,18,9,9
1043,21,395,4351600,169,93,76
1044,21,395,4351700,78,39,39
1045,21,395,4351800,0,0,0
1046,21,395,4351900,107,54,53
1047,21,395,4352000,416,208,208
1048,21,395,4352100,0,0,0
1049,21,395,4352200,270,125,145
1050,21,395,4352300,257,109,148
1051,21,395,4352400,102,47,55
1052,21,395,4352500,76,40,36
1053,21,395,4352600,0,0,0
1054,21,395,4352700,474,225,249
1055,21,395,4352800,548,275,273
1056,21,395,4352900,42,19,23
1057,21,395,4353000,517,256,261
1058,21,395,4353100,169,82,87
1059,21,395,4353200,0,0,0
1060,21,395,4353300,184,92,92
1061,21,395,4353400,240,117,123
1062,21,395,4353500,591,271,320
1063,21,395,4353600,1063,521,542
1064,21,395,4353700,725,355,370
1065,21,395,4353800,577,294,283
1066,21,395,4353900,285,135,150
1067,21,395,4354000,166,76,90
1068,21,395,4354100,790,403,387
1069,21,395,4354200,715,345,370
1070,21,395,4354300,268,132,136
1071,21,395,4354400,291,132,159
1072,21,395,4354500,1725,866,859
1073,21,395,4354600,0,0,0
1074,21,395,4354700,1325,645,680
1075,21,395,4354800,581,338,243
1076,21,395,4354900,62,33,29
1077,21,395,4355000,20,11,9
1078,21,395,4355100,0,0,0
1079,21,395,4355200,119,50,69
1080,21,395,4355300,179,80,99
1081,21,395,4355400,151,67,84
1082,21,395,4355500,145,68,77
1083,21,395,4355600,72,40,32
1084,21,395,4355700,129,64,65
1085,21,395,4355800,76,41,35
1086,21,395,4355900,269,136,133
1087,21,395,4356000,0,0,0
1088,21,395,4356100,43,17,26
1089,21,395,4356200,17,10,7
1090,21,395,4356300,96,48,48
1091,21,395,4356400,160,83,77
1092,21,395,4356500,4,2,2
1093,21,395,4356600,58,26,32
1094,21,395,4356700,46,19,27
1095,21,395,4356800,137,64,73
1096,21,395,4356900,93,40,53
1097,21,395,4357000,49,25,24
1098,21,395,4357100,23,10,13
1099,21,395,4357200,193,84,109
1100,21,395,4357300,68,31,37
1101,21,395,4357400,92,50,42
1102,21,395,4357500,347,161,186
1103,21,395,4357600,57,25,32
1104,21,395,4357700,48,23,25
1105,21,395,4357800,28,12,16
1106,21,395,4357900,168,72,96
1107,21,395,4358000,181,90,91
1108,21,395,4358100,72,33,39
1109,21,395,4358200,0,0,0
1110,21,395,4358300,24,11,13
1111,21,395,4358400,0,0,0
1112,21,395,4358500,71,32,39
1113,21,395,4358600,62,33,29
1114,21,395,4358700,26,13,13
1115,21,395,4358800,0,0,0
1116,21,395,4358900,542,275,267
1117,21,395,4359000,140,67,73
1118,21,395,4359100,0,0,0
1119,21,395,4359200,198,96,102
1120,21,395,4359300,101,49,52
1121,21,395,4359400,146,77,69
1122,21,395,4359500,27,13,14
1123,21,395,4359600,138,67,71
1124,21,395,4359700,82,35,47
1125,21,395,4359800,60,26,34
1126,21,395,4359900,275,140,135
1127,21,395,4360000,187,93,94
1128,21,395,4360100,264,143,121
1129,21,395,4360200,65,31,34
1130,21,395,4360300,16,8,8
1131,21,395,4360400,98,42,56
1132,21,395,4360500,93,42,51
1133,21,395,4360600,62,32,30
1134,21,395,4360700,91,47,44
1135,21,395,4360800,474,235,239
1136,21,395,4360900,489,232,257
1137,21,395,4361000,108,60,48
1138,21,395,4361100,826,419,407
1139,21,395,4361200,348,174,174
1140,21,395,4361300,121,55,66
1141,21,395,4361400,307,152,155
1142,21,395,4361500,23,12,11
1143,21,395,4361600,392,189,203
1144,21,395,4361700,436,208,228
1145,21,395,4361800,26,12,14
1146,21,395,4361900,173,92,81
1147,21,395,4362000,0,0,0
1148,21,395,4362100,0,0,0
1149,21,395,4362200,896,466,430
1150,21,395,4362300,448,213,235
1151,21,395,4362400,935,481,454
1152,21,395,4362500,1608,791,817
1153,21,395,4362600,2032,1014,1018
1154,21,395,4362700,567,276,291
1155,21,395,4362800,386,181,205
1156,21,395,4362900,516,253,263
1157,21,395,4363000,640,325,315
1158,21,395,4363100,434,243,191
1159,21,395,4363200,403,210,193
1160,21,395,4363300,1287,618,669
1161,21,395,4363400,1551,797,754
1162,21,395,4363500,2392,1224,1168
1163,21,395,4363600,121,57,64
1164,21,395,4363700,621,291,330
1165,21,395,4363800,1264,618,646
1166,21,395,4363900,474,229,245
1167,21,395,4364000,569,261,308
1168,21,395,4364100,332,168,164
1169,21,395,4364200,151,80,71
1170,21,395,4364300,224,111,113
1171,21,395,4364400,124,68,56
1172,21,395,4364500,463,229,234
1173,21,395,4364600,172,90,82
1174,21,395,4364700,173,91,82
1175,21,395,4364800,0,0,0
1176,21,395,4364900,28,12,16
1177,21,395,4365000,67,32,35
1178,21,395,4365100,254,128,126
1179,21,395,4365200,334,176,158
1180,21,395,4365300,265,128,137
1181,21,395,4365400,277,136,141
1182,21,395,4365500,424,214,210
1183,21,395,4365600,19,11,8
1184,21,395,4365700,496,271,225
1185,21,395,4365800,431,217,214
1186,21,395,4365900,154,86,68
1187,21,395,4366000,160,91,69
1188,21,395,4366100,1078,535,543
1189,21,395,4366200,454,233,221
1190,21,395,4366300,305,149,156
1191,21,395,4366400,1773,895,878
1192,21,395,4366500,158,84,74
1193,21,395,4366600,469,236,233
1194,21,395,4366700,1260,614,646
1195,21,395,4366800,1041,503,538
1196,21,395,4366900,1349,652,697
1197,21,395,4367000,2627,1282,1345
1198,21,395,4367100,785,386,399
1199,21,395,4367200,778,388,390
1200,21,395,4367300,254,129,125
1201,21,395,4367400,1022,500,522
1202,21,395,4367500,1424,733,691
1203,21,395,4367600,1744,896,848
1204,21,395,4367700,1741,880,861
1205,21,395,4367800,654,316,338
1206,21,395,4367900,645,330,315
1207,21,395,4368000,830,425,405
1208,21,395,4368100,410,197,213
1209,21,395,4368200,260,136,124
1210,21,395,4368300,181,92,89
1211,21,395,4368400,488,233,255
1212,21,395,4368500,574,284,290
1213,21,395,4368600,1005,473,532
1214,21,395,4368700,1548,794,754
1215,21,395,4368800,9274,4827,4447
1216,21,395,4368900,725,370,355
1217,21,395,4369000,206,104,102
1218,21,395,4369100,689,350,339
1219,21,395,4369200,441,197,244
1220,21,395,4369300,0,0,0
1221,21,395,4369400,481,227,254
1222,21,395,4369500,71,40,31
1223,21,395,4369600,295,145,150
1224,21,395,4369700,173,92,81
1225,21,395,4369800,708,358,350
1226,21,395,4369900,406,203,203
1227,21,395,4370000,314,146,168
1228,21,395,4370100,357,168,189
1229,21,395,4370200,239,120,119
1230,21,395,4370300,144,80,64
1231,21,395,4370400,157,80,77
1232,21,395,4370500,40,20,20
1233,21,395,4370600,0,0,0
1234,21,395,4370700,55,23,32
1235,21,395,4370800,143,75,68
1236,21,395,4370900,94,47,47
1237,21,395,4371000,85,42,43
1238,21,395,4371100,109,58,51
1239,21,395,4371200,154,77,77
1240,21,395,4371300,295,136,159
1241,21,395,4371400,46,25,21
1242,21,395,4371500,432,210,222
1243,21,395,4371600,40,19,21
1244,21,395,4371700,35,23,12
1245,21,395,4371800,533,264,269
1246,21,395,4371900,55,28,27
1247,21,395,4372000,27,12,15
1248,21,395,4372100,242,124,118
1249,21,395,4372200,116,69,47
1250,21,395,4372300,199,94,105
1251,21,395,4372400,130,75,55
1252,21,395,4372500,293,143,150
1253,21,395,4372600,0,0,0
1254,21,395,4372700,286,136,150
1255,21,395,4372800,456,220,236
1256,21,395,4372900,1186,693,493
1257,21,395,4373000,448,206,242
1258,21,395,4373100,322,182,140
1259,21,395,4373200,397,216,181
1260,21,395,4373300,101,63,38
1261,21,395,4373400,0,0,0
1262,21,395,4373500,82,42,40
1263,21,395,4373600,75,32,43
1264,21,395,4373700,129,58,71
1265,21,395,4373800,0,0,0
1266,21,395,4373900,0,0,0
1267,21,395,4374000,82,39,43
1268,21,395,4374100,292,130,162
1269,21,395,4374200,40,20,20
1270,21,395,4374300,88,41,47
1271,21,395,4374400,270,146,124
1272,21,395,4374500,90,43,47
1273,21,395,4374600,136,62,74
1274,21,395,4374700,49,27,22
1275,21,395,4374800,83,38,45
1276,21,395,4374900,0,0,0
1277,21,395,4375000,94,47,47
1278,21,395,4375100,73,40,33
1279,21,395,4375200,9,5,4
1280,21,395,4375300,38,20,18
1281,21,395,4375400,71,32,39
1282,21,395,4375500,0,0,0
1283,21,395,4375600,42,23,19
1284,21,395,4375700,0,0,0
1285,21,395,4375800,204,101,103
1286,21,395,4375900,0,0,0
1287,21,395,4376000,0,0,0
1288,21,395,4376100,43,17,26
1289,21,395,4376200,25,9,16
1290,21,395,4376300,16,9,7
1291,21,395,4376400,190,82,108
1292,21,395,4376500,102,43,59
1293,21,395,4376600,19,10,9
1294,21,395,4376700,18,9,9
1295,21,395,4376800,43,23,20
1296,21,395,4376900,383,201,182
1297,21,395,4377000,811,388,423
1298,21,395,4377100,99,50,49
1299,21,395,4377200,98,46,52
1300,21,395,4377300,309,168,141
1301,21,395,4377400,104,48,56
1302,21,395,4377500,23,11,12
1303,21,395,4377600,104,49,55
1304,21,395,4377700,292,125,167
1305,21,395,4377800,0,0,0
1306,21,395,4377900,495,260,235
1307,21,395,4378000,64,27,37
1308,21,395,4378100,214,98,116
1309,21,395,4378200,134,72,62
1310,21,395,4378300,31,9,22
1311,21,395,4378400,536,262,274
1312,21,395,4378500,0,0,0
1313,21,395,4378600,295,146,149
1314,21,395,4378700,140,73,67
1315,21,395,4378800,75,31,44
1316,21,395,4378900,11,8,3
1317,21,395,4379000,108,41,67
1318,21,395,4379100,33,18,15
1319,21,395,4379200,3502,1809,1693
1320,21,395,4379300,234,117,117
1321,21,395,4379400,283,152,131
1322,21,395,4379500,753,399,354
1323,21,395,4379600,165,80,85
1324,21,395,4379700,292,135,157
1325,21,395,4379800,64,38,26
1326,21,395,4379900,285,150,135
1327,21,395,4380000,69,27,42
1328,21,395,4380100,0,0,0
1329,21,395,4380200,503,236,267
1330,21,395,4380300,411,218,193
1331,21,395,4380400,83,39,44
1332,21,395,4380500,164,76,88
1333,21,395,4380600,188,94,94
1334,21,395,4380700,76,38,38
1335,21,395,4380800,428,210,218
1336,21,395,4380900,43,27,16
1337,21,395,4381000,234,120,114
1338,21,395,4381100,373,184,189
1339,21,395,4381200,85,39,46
1340,21,395,4381300,700,316,384
1341,21,395,4381400,214,99,115
1342,21,395,4381500,366,176,190
1343,21,395,4381600,389,181,208
1344,21,395,4381700,98,40,58
1345,21,395,4381800,262,120,142
1346,21,395,4381900,915,462,453
1347,21,395,4382000,181,78,103
1348,21,395,4382100,0,0,0
1349,21,395,4382200,224,109,115
1350,21,395,4382300,0,0,0
1351,21,395,4382400,425,204,221
1352,21,395,4382500,181,92,89
1353,21,395,4382600,201,94,107
1354,21,395,4382700,80,40,40
1355,21,395,4382800,205,112,93
1356,21,395,4382900,152,69,83
1357,21,395,4383000,193,88,105
1358,21,395,4383100,189,92,97
1359,21,395,4383200,874,447,427
1360,21,395,4383300,674,342,332
1361,21,395,4383400,738,363,375
1362,21,395,4383500,203,99,104
1363,21,395,4383600,88,48,40
1364,21,395,4383700,0,0,0
1365,21,395,4383800,668,322,346
1366,21,395,4383900,551,276,275
1367,21,395,4384000,488,236,252
1368,21,395,4384100,0,0,0
1369,21,395,4384200,106,54,52
1370,21,395,4384300,83,40,43
1371,21,395,4384400,113,56,57
1372,21,395,4384500,102,50,52
1373,21,395,4384600,321,158,163
1374,21,395,4384700,176,83,93
1375,21,395,4384800,172,91,81
1376,21,395,4384900,559,292,267
1377,21,395,4385000,132,64,68
1378,21,395,4385100,208,96,112
1379,21,395,4385200,142,63,79
1380,21,395,4385300,172,82,90
1381,21,395,4385400,235,116,119
1382,21,395,4385500,127,63,64
1383,21,395,4385600,72,32,40
1384,21,395,4385700,98,42,56
1385,21,395,4385800,233,102,131
1386,21,395,4385900,109,52,57
1387,21,395,4386000,175,90,85
1388,21,395,4386100,295,146,149
1389,21,395,4386200,973,463,510
1390,21,395,4386300,264,142,122
1391,21,395,4386400,232,106,126
1392,21,395,4386500,525,245,280
1393,21,395,4386600,115,52,63
1394,21,395,4386700,0,0,0
1395,21,395,4386800,0,0,0
1396,21,395,4386900,355,168,187
1397,21,395,4387000,942,462,480
1398,21,395,4387100,337,159,178
1399,21,395,4387200,65,38,27
1400,21,395,4387300,529,265,264
1401,21,395,4387400,697,345,352
1402,21,395,4387500,34,17,17
1403,21,395,4387600,0,0,0
1404,21,395,4387700,310,149,161
1405,21,395,4387800,0,0,0
1406,21,395,4387900,68,33,35
1407,21,395,4388000,40,17,23
1408,21,395,4388100,111,48,63
1409,21,395,4388200,0,0,0
1410,21,395,4388300,64,32,32
1411,21,395,4388400,145,65,80
1412,21,395,4388500,521,286,235
1413,21,395,4388600,167,86,81
1414,21,395,4388700,71,28,43
1415,21,395,4388800,76,38,38
1416,21,395,4388900,294,150,144
1417,21,395,4389000,104,49,55
1418,21,395,4389100,82,42,40
1419,21,395,4389200,241,109,132
1420,21,395,4389300,370,182,188
1421,21,395,4389400,168,83,85
1422,21,395,4389500,205,98,107
1423,21,395,4389600,271,134,137
1424,21,395,4389700,299,153,146
1425,21,395,4389800,0,0,0
1426,21,395,4389900,974,478,496
1427,21,395,4390000,266,143,123
1428,21,395,4390100,235,109,126
1429,21,395,4390200,370,188,182
1430,21,395,4390300,120,54,66
1431,21,395,4390400,164,86,78
1432,21,395,4390500,112,56,56
1433,21,395,4390600,0,0,0
1434,21,395,4390700,313,164,149
1435,21,395,4390800,39,19,20
1436,21,395,4390900,129,67,62
1437,21,395,4391000,121,57,64
1438,21,395,4391100,0,0,0
1439,21,395,4391200,871,432,439
1440,21,395,4391300,214,112,102
1441,21,395,4391400,180,85,95
1442,21,395,4391500,96,41,55
1443,21,395,4391600,43,24,19
1444,21,395,4391700,193,88,105
1445,21,395,4391800,281,140,141
1446,21,395,4391900,1,0,1
1447,21,395,4392000,3911,2024,1887
1448,21,395,4392100,173,93,80
1449,21,395,4392200,138,72,66
1450,21,395,4392300,43,23,20
1451,21,395,4392400,48,20,28
1452,21,395,4392500,80,32,48
1453,21,395,4392600,208,91,117
1454,21,395,4392700,201,82,119
1455,21,395,4392800,128,69,59
1456,21,395,4392900,462,236,226
1457,21,395,4393000,241,125,116
1458,21,395,4393100,441,227,214
1459,21,395,4393200,487,243,244
1460,21,395,4393300,134,65,69
1461,21,395,4393400,198,91,107
1462,21,395,4393500,154,76,78
1463,21,395,4393600,190,84,106
1464,21,395,4393700,324,153,171
1465,21,395,4393800,65,38,27
1466,21,395,4393900,0,0,0
1467,21,395,4394000,0,0,0
1468,21,395,4394100,270,120,150
1469,21,395,4394200,733,372,361
1470,21,395,4394300,590,292,298
1471,21,395,4394400,212,102,110
1472,21,395,4394500,96,47,49
1473,21,395,4394600,342,172,170
1474,21,395,4394700,435,218,217
1475,21,395,4394800,67,32,35
1476,21,395,4394900,348,160,188
1477,21,395,4395000,48,19,29
1478,21,395,4395100,77,40,37
1479,21,395,4395200,166,76,90
1480,21,395,4395300,614,308,306
1481,21,395,4395400,225,119,106
1482,21,395,4395500,973,473,500
1483,21,395,4395600,4,3,1
1484,21,395,4395700,0,0,0
1485,21,395,4395800,0,0,0
1486,21,395,4395900,160,78,82
1487,21,395,4396000,0,0,0
1488,21,395,4396100,0,0,0
1489,21,395,4396200,50,25,25
1490,21,395,4396300,0,0,0
1491,21,395,4396400,0,0,0
1492,21,395,4396500,176,82,94
1493,21,395,4396600,91,52,39
1494,21,395,4396700,62,28,34
1495,21,395,4396800,422,203,219
1496,21,395,4396900,647,300,347
1497,21,395,4397000,62,25,37
1498,21,395,4397100,293,136,157
1499,21,395,4397200,127,67,60
1500,21,395,4397300,111,50,61
1501,21,395,4397400,153,73,80
1502,21,395,4397500,17,9,8
1503,21,395,4397600,773,358,415
1504,21,395,4397700,483,231,252
1505,21,395,4397800,696,357,339
1506,21,395,4397900,27,12,15
1507,21,395,4398000,28,10,18
1508,21,395,4398100,84,42,42
1509,21,395,4398200,100,47,53
1510,21,395,4398300,2,1,1
1511,21,395,4398400,92,47,45
1512,21,395,4398500,0,0,0
1513,21,395,4398600,23,8,15
1514,21,395,4398700,0,0,0
1515,21,395,4398800,46,24,22
1516,21,395,4398900,138,75,63
1517,21,395,4399000,146,65,81
1518,21,395,4399100,90,39,51
1519,21,395,4399200,39,19,20
1520,21,395,4399300,25,10,15
1521,21,395,4399400,39,19,20
1522,21,395,4399500,19,9,10
1523,21,395,4399600,71,34,37
1524,21,395,4399700,115,57,58
1525,21,395,4399800,40,18,22
1526,21,395,4399900,146,69,77
1527,21,395,4400000,179,76,103
1528,21,395,4400100,54,24,30
1529,21,395,4400200,68,38,30
1530,21,395,4400300,153,77,76
1531,21,395,4400400,226,115,111
1532,21,395,4400500,179,73,106
1533,21,395,4400600,383,195,188
1534,21,395,4400700,463,261,202
1535,21,395,4400800,136,75,61
1536,21,395,4400900,313,142,171
1537,21,395,4401000,101,50,51
1538,21,395,4401100,342,160,182
1539,21,395,4401200,124,54,70
1540,21,395,4401300,101,48,53
1541,21,395,4401400,63,27,36
1542,21,395,4401500,559,258,301
1543,21,395,4401600,201,99,102
1544,21,395,4401700,281,144,137
1545,21,395,4401800,75,39,36
1546,21,395,4401900,119,63,56
1547,21,395,4402000,196,91,105
1548,21,395,4402100,313,176,137
1549,21,395,4402200,78,33,45
1550,21,395,4402300,125,62,63
1551,21,395,4402400,115,56,59
1552,21,395,4402500,135,68,67
1553,21,395,4402600,48,20,28
1554,21,395,4402700,0,0,0
1555,21,395,4402800,214,93,121
1556,21,395,4402900,544,269,275
1557,21,395,4403000,0,0,0
1558,21,395,4403100,199,99,100
1559,21,395,4403200,99,50,49
1560,21,395,4403300,0,0,0
1561,21,395,4403400,340,164,176
1562,21,395,4403500,236,117,119
1563,21,395,4403600,220,107,113
1564,21,395,4403700,113,56,57
1565,21,395,4403800,0,0,0
1566,21,395,4403900,107,55,52
1567,21,395,4404000,275,125,150
1568,21,395,4404100,101,47,54
1569,21,395,4404200,117,48,69
1570,21,395,4404300,0,0,0
1571,21,395,4404400,75,34,41
1572,21,395,4404500,416,183,233
1573,21,395,4404600,172,80,92
1574,21,395,4404700,96,58,38
1575,21,395,4404800,23,10,13
1576,21,395,4404900,164,76,88
1577,21,395,4405000,577,278,299
1578,21,395,4405100,307,159,148
1579,21,395,4405200,88,39,49
1580,21,395,4405300,64,33,31
1581,21,395,4405400,0,0,0
1582,21,395,4405500,106,54,52
1583,21,395,4405600,277,132,145
1584,21,395,4405700,68,34,34
1585,21,395,4405800,83,32,51
1586,21,395,4405900,213,98,115
1587,21,395,4406000,83,38,45
1588,21,395,4406100,88,43,45
1589,21,395,4406200,35,13,22
1590,21,395,4406300,165,77,88
1591,21,395,4406400,28,11,17
1592,21,395,4406500,60,26,34
1593,21,395,4406600,269,119,150
1594,21,395,4406700,910,458,452
1595,21,395,4406800,240,112,128
1596,21,395,4406900,301,134,167
1597,21,395,4407000,478,224,254
1598,21,395,4407100,145,69,76
1599,21,395,4407200,768,411,357
1600,21,395,4407300,90,43,47
1601,21,395,4407400,216,102,114
1602,21,395,4407500,55,31,24
1603,21,395,4407600,24,11,13
1604,21,395,4407700,480,213,267
1605,21,395,4407800,46,23,23
1606,21,395,4407900,98,41,57
1607,21,395,4408000,342,152,190
1608,21,395,4408100,302,145,157
1609,21,395,4408200,187,94,93
1610,21,395,4408300,314,151,163
1611,21,395,4408400,0,0,0
1612,21,395,4408500,190,92,98
1613,21,395,4408600,245,128,117
1614,21,395,4408700,119,68,51
1615,21,395,4408800,485,220,265
1616,21,395,4408900,92,42,50
1617,21,395,4409000,546,278,268
1618,21,395,4409100,0,0,0
1619,21,395,4409200,184,82,102
1620,21,395,4409300,25,12,13
1621,21,395,4409400,16,8,8
1622,21,395,4409500,24,9,15
1623,21,395,4409600,747,394,353
1624,21,395,4409700,266,140,126
1625,21,395,4409800,71,33,38
1626,21,395,4409900,24,9,15
1627,21,395,4410000,0,0,0
1628,21,395,4410100,159,75,84
1629,21,395,4410200,214,112,102
1630,21,395,4410300,523,253,270
1631,21,395,4410400,91,77,14
1632,21,395,4410500,321,151,170
1633,21,395,4410600,108,54,54
1634,21,395,4410700,27,13,14
1635,21,395,4410800,54,25,29
1636,21,395,4410900,119,52,67
1637,21,395,4411000,20,12,8
1638,21,395,4411100,43,24,19
1639,21,395,4411200,108,57,51
1640,21,395,4411300,204,96,108
1641,21,395,4411400,462,234,228
1642,21,395,4411500,214,108,106
1643,21,395,4411600,102,54,48
1644,21,395,4411700,124,60,64
1645,21,395,4411800,64,35,29
1646,21,395,4411900,268,138,130
1647,21,395,4412000,552,269,283
1648,21,395,4412100,195,96,99
1649,21,395,4412200,671,338,333
1650,21,395,4412300,389,187,202
1651,21,395,4412400,236,119,117
1652,21,395,4412500,889,433,456
1653,21,395,4412600,447,224,223
1654,21,395,4412700,673,331,342
1655,21,395,4412800,491,405,86
1656,21,395,4412900,56,28,28
1657,21,395,4413000,1005,491,514
1658,21,395,4413100,158,76,82
1659,21,395,4413200,391,206,185
1660,21,395,4413300,0,0,0
1661,21,395,4413400,220,108,112
1662,21,395,4413500,153,67,86
1663,21,395,4413600,77,38,39
1664,21,395,4413700,123,69,54
1665,21,395,4413800,34,12,22
1666,21,395,4413900,160,77,83
1667,21,395,4414000,478,248,230
1668,21,395,4414100,121,55,66
1669,21,395,4414200,223,108,115
1670,21,395,4414300,204,94,110
1671,21,395,4414400,63,31,32
1672,21,395,4414500,247,121,126
1673,21,395,4414600,96,40,56
1674,21,395,4414700,119,71,48
1675,21,395,4414800,50,24,26
1676,21,395,4414900,248,119,129
1677,21,395,4415000,346,164,182
1678,21,395,4415100,157,71,86
1679,21,395,4415200,124,63,61
1680,21,395,4415300,34,16,18
1681,21,395,4415400,132,60,72
1682,21,395,4415500,208,85,123
1683,21,395,4415600,85,46,39
1684,21,395,4415700,221,119,102
1685,21,395,4415800,324,164,160
1686,21,395,4415900,332,153,179
1687,21,395,4416000,0,0,0
1688,21,395,4416100,85,49,36
1689,21,395,4416200,217,112,105
1690,21,395,4416300,264,123,141
1691,21,395,4416400,206,94,112
1692,21,395,4416500,75,38,37
1693,21,395,4416600,0,0,0
1694,21,395,4416700,275,136,139
1695,21,395,4416800,406,183,223
1696,21,395,4416900,0,0,0
1697,21,395,4417000,298,158,140
1698,21,395,4417100,0,0,0
1699,21,395,4417200,33,19,14
1700,21,395,4417300,377,181,196
1701,21,395,4417400,23,11,12
1702,21,395,4417500,235,112,123
1703,21,395,4417600,183,93,90
1704,21,395,4417700,90,43,47
1705,21,395,4417800,85,39,46
1706,21,395,4417900,129,60,69
1707,21,395,4418000,33,12,21
1708,21,395,4418100,150,75,75
1709,21,395,4418200,38,20,18
1710,21,395,4418300,85,39,46
1711,21,395,4418400,258,120,138
1712,21,395,4418500,68,39,29
1713,21,395,4418600,216,99,117
1714,21,395,4418700,115,50,65
1715,21,395,4418800,94,41,53
1716,21,395,4418900,96,41,55
1717,21,395,4419000,565,273,292
1718,21,395,4419100,0,0,0
1719,21,395,4419200,500,254,246
1720,21,395,4419300,273,146,127
1721,21,395,4419400,113,58,55
1722,21,395,4419500,76,28,48
1723,21,395,4419600,64,28,36
1724,21,395,4419700,62,26,36
1725,21,395,4419800,205,91,114
1726,21,395,4419900,125,63,62
1727,21,395,4420000,146,71,75
1728,21,395,4420100,425,197,228
1729,21,395,4420200,432,205,227
1730,21,395,4420300,295,138,157
1731,21,395,4420400,204,94,110
1732,21,395,4420500,362,172,190
1733,21,395,4420600,358,180,178
1734,21,395,4420700,172,84,88
1735,21,395,4420800,208,109,99
1736,21,395,4420900,129,58,71
1737,21,395,4421000,254,107,147
1738,21,395,4421100,108,60,48
1739,21,395,4421200,322,150,172
1740,21,395,4421300,536,239,297
1741,21,395,4421400,189,86,103
1742,21,395,4421500,241,115,126
1743,21,395,4421600,419,300,119
1744,21,395,4421700,275,159,116
1745,21,395,4421800,418,196,222
1746,21,395,4421900,515,257,258
1747,21,395,4422000,56,32,24
1748,21,395,4422100,345,159,186
1749,21,395,4422200,626,175,451
1750,21,395,4422300,471,231,240
1751,21,395,4422400,301,150,151
1752,21,395,4422500,459,223,236
1753,21,395,4422600,435,204,231
1754,21,395,4422700,283,142,141
1755,21,395,4422800,488,284,204
1756,21,395,4422900,84,33,51
1757,21,395,4423000,204,101,103
1758,21,395,4423100,820,394,426
1759,21,395,4423200,82,38,44
1760,21,395,4423300,353,161,192
1761,21,395,4423400,302,138,164
1762,21,395,4423500,145,73,72
1763,21,395,4423600,2989,1583,1406
1764,21,395,4423700,897,432,465
1765,21,395,4423800,431,210,221
1766,21,395,4423900,175,88,87
1767,21,395,4424000,432,224,208
1768,21,395,4424100,232,113,119
1769,21,395,4424200,91,42,49
1770,21,395,4424300,234,109,125
1771,21,395,4424400,169,92,77
1772,21,395,4424500,922,597,325
1773,21,395,4424600,514,245,269
1774,21,395,4424700,622,276,346
1775,21,395,4424800,382,188,194
1776,21,395,4424900,243,111,132
1777,21,395,4425000,473,234,239
1778,21,395,4425100,459,216,243
1779,21,395,4425200,167,88,79
1780,21,395,4425300,812,386,426
1781,21,395,4425400,756,357,399
1782,21,395,4425500,247,117,130
1783,21,395,4425600,502,299,203
1784,21,395,4425700,241,117,124
1785,21,395,4425800,342,164,178
1786,21,395,4425900,724,357,367
1787,21,395,4426000,119,50,69
1788,21,395,4426100,279,142,137
1789,21,395,4426200,628,322,306
1790,21,395,4426300,210,109,101
1791,21,395,4426400,308,145,163
1792,21,395,4426500,77,35,42
1793,21,395,4426600,220,100,120
1794,21,395,4426700,174,88,86
1795,21,395,4426800,747,357,390
1796,21,395,4426900,299,144,155
1797,21,395,4427000,893,427,466
1798,21,395,4427100,803,380,423
1799,21,395,4427200,618,287,331
1800,21,395,4427300,530,264,266
1801,21,395,4427400,331,161,170
1802,21,395,4427500,1779,873,906
1803,21,395,4427600,107,52,55
1804,21,395,4427700,672,435,237
1805,21,395,4427800,268,135,133
1806,21,395,4427900,786,384,402
1807,21,395,4428000,626,307,319
1808,21,395,4428100,619,295,324
1809,21,395,4428200,262,144,118
1810,21,395,4428300,663,328,335
1811,21,395,4428400,620,305,315
1812,21,395,4428500,440,206,234
1813,21,395,4428600,1042,506,536
1814,21,395,4428700,175,83,92
1815,21,395,4428800,709,328,381
1816,21,395,4428900,1273,630,643
1817,21,395,4429000,96,49,47
1818,21,395,4429100,101,50,51
1819,21,395,4429200,235,121,114
1820,21,395,4429300,175,78,97
1821,21,395,4429400,58,27,31
1822,21,395,4429500,98,48,50
1823,21,395,4429600,583,278,305
1824,21,395,4429700,91,42,49
1825,21,395,4429800,0,0,0
1826,21,395,4429900,292,151,141
1827,21,395,4430000,1576,804,772
1828,21,395,4430100,317,150,167
1829,21,395,4430200,350,165,185
1830,21,395,4430300,657,308,349
1831,21,395,4430400,1335,627,708
1832,21,395,4430500,106,54,52
1833,21,395,4430600,765,367,398
1834,21,395,4430700,665,334,331
1835,21,395,4430800,101,50,51
1836,21,395,4430900,193,94,99
1837,21,395,4431000,328,144,184
1838,21,395,4431100,403,198,205
1839,21,395,4431200,511,276,235
1840,21,395,4431300,253,125,128
1841,21,395,4431400,0,0,0
1842,21,395,4431500,159,73,86
1843,21,395,4431600,301,151,150
1844,21,395,4431700,198,86,112
1845,21,395,4431800,0,0,0
1846,21,395,4431900,406,191,215
1847,21,395,4432000,165,80,85
1848,21,395,4432100,241,119,122
1849,21,395,4432200,233,119,114
1850,21,395,4432300,67,35,32
1851,21,395,4432400,530,260,270
1852,21,395,4432500,144,72,72
1853,21,395,4432600,269,136,133
1854,21,395,4432700,132,64,68
1855,21,395,4432800,428,201,227
1856,21,395,4432900,201,98,103
1857,21,395,4433000,657,309,348
1858,21,395,4433100,486,234,252
1859,21,395,4433200,0,0,0
1860,21,395,4433300,0,0,0
1861,21,395,4433400,657,315,342
1862,21,395,4433500,390,203,187
1863,21,395,4433600,0,0,0
1864,21,395,4433700,145,71,74
1865,21,395,4433800,94,46,48
1866,21,395,4433900,2,1,1
1867,21,395,4434000,0,0,0
1868,21,395,4434100,701,345,356
1869,21,395,4434200,135,65,70
1870,21,395,4434300,143,69,74
1871,21,395,4434400,258,132,126
1872,21,395,4434500,113,50,63
1873,21,395,4434600,0,0,0
1874,21,395,4434700,0,0,0
1875,21,395,4434800,317,142,175
1876,21,395,4434900,478,223,255
1877,21,395,4435000,52,28,24
1878,21,395,4435100,0,0,0
1879,21,395,4435200,0,0,0
1880,21,395,4435300,354,166,188
1881,21,395,4435400,104,50,54
1882,21,395,4435500,27,11,16
1883,21,395,4435600,101,49,52
1884,21,395,4435700,448,208,240
1885,21,395,4435800,160,80,80
1886,21,395,4435900,278,128,150
1887,21,395,4436000,1643,815,828
1888,21,395,4436100,3114,1513,1601
1889,21,395,4436200,275,146,129
1890,21,395,4436300,154,77,77
1891,21,395,4436400,351,167,184
1892,21,395,4436500,241,120,121
1893,21,395,4436600,492,240,252
1894,21,395,4436700,1167,583,584
1895,21,395,4436800,4124,2055,2069
1896,21,395,4436900,790,398,392
1897,21,395,4437000,3263,1662,1601
1898,21,395,4437100,2137,1090,1047
1899,21,395,4437200,1630,863,767
1900,21,395,4437300,1222,620,602
1901,21,395,4437400,725,359,366
1902,21,395,4437500,1519,760,759
1903,21,395,4437600,770,402,368
1904,21,395,4437700,697,361,336
1905,21,395,4437800,673,336,337
1906,21,395,4437900,2159,1081,1078
1907,21,395,4438000,2009,1011,998
1908,21,395,4438100,2485,1200,1285
1909,21,395,4438200,1774,887,887
1910,21,395,4438300,1890,925,965
1911,21,395,4438400,1071,522,549
1912,21,395,4438500,0,0,0
1913,21,395,4438600,175,88,87
1914,21,395,4438700,603,293,310
1915,21,395,4438800,1370,700,670
1916,21,395,4438900,1365,657,708
1917,21,395,4439000,2760,1345,1415
1918,21,395,4439100,1063,547,516
1919,21,395,4439200,474,221,253
1920,21,395,4439300,1703,858,845
1921,21,395,4439400,628,306,322
1922,21,395,4439500,77,38,39
1923,21,395,4439600,235,109,126
1924,21,395,4439700,391,198,193
1925,21,395,4439800,1111,555,556
1926,21,395,4439900,1213,610,603
1927,21,395,4440000,1349,657,692
1928,21,395,4440100,1102,538,564
1929,21,395,4440200,1520,751,769
1930,21,395,4440300,2132,1053,1079
1931,21,395,4440400,439,225,214
1932,21,395,4440500,1064,535,529
1933,21,395,4440600,1246,588,658
1934,21,395,4440700,249,132,117
1935,21,395,4440800,1563,763,800
1936,21,395,4440900,811,392,419
1937,21,395,4441000,666,322,344
1938,21,395,4441100,976,491,485
1939,21,395,4441200,807,405,402
1940,21,395,4441300,72,41,31
1941,21,395,4441400,513,260,253
1942,21,395,4441500,1107,551,556
1943,21,395,4441600,1011,498,513
1944,21,395,4441700,409,291,118
1945,21,395,4441800,748,363,385
1946,21,395,4441900,1465,700,765
1947,21,395,4442000,2453,1200,1253
1948,21,395,4442100,2721,1357,1364
1949,21,395,4442200,1013,503,510
1950,21,395,4442300,1711,872,839
1951,21,395,4442400,2780,1349,1431
1952,21,395,4442500,2636,1319,1317
1953,21,395,4442600,1446,725,721
1954,21,395,4442700,1050,539,511
1955,21,395,4442800,628,308,320
1956,21,395,4442900,2920,1467,1453
1957,21,395,4443000,251,112,139
1958,21,395,4443100,1253,650,603
1959,21,395,4443200,1405,718,687
1960,21,395,4443300,1042,524,518
1961,21,395,4443400,1476,733,743
1962,21,395,4443500,0,0,0
1963,21,395,4443600,0,0,0
1964,21,395,4443700,3734,1898,1836
1965,21,395,4443800,3969,2030,1939
1966,21,395,4443900,1369,691,678
1967,21,395,4444000,1349,673,676
1968,21,395,4444100,3281,1683,1598
1969,21,395,4444200,1094,568,526
1970,21,395,4444300,1326,672,654
1971,21,395,4444400,2905,1487,1418
1972,21,395,4444500,935,456,479
1973,21,395,4444600,1809,903,906
1974,21,395,4444700,499,241,258
1975,21,395,4444800,847,403,444
1976,21,395,4444900,1013,509,504
1977,21,395,4445000,2505,1236,1269
1978,21,395,4445100,1855,917,938
1979,21,395,4445200,1101,540,561
1980,21,395,4445300,239,119,120
1981,21,395,4445400,1008,500,508
1982,21,395,4445500,8,2,6
1983,21,395,4445600,900,451,449
1984,21,395,4445700,706,377,329
1985,21,395,4445800,144,76,68
1986,21,395,4445900,62,26,36
1987,21,395,4446000,1005,508,497
1988,21,395,4446100,223,117,106
1989,21,395,4446200,1293,630,663
1990,21,395,4446300,671,342,329
1991,21,395,4446400,213,102,111
1992,21,395,4446500,275,130,145
1993,21,395,4446600,1155,565,590
1994,21,395,4446700,817,426,391
1995,21,395,4446800,1046,517,529
1996,21,395,4446900,0,0,0
1997,21,395,4447000,153,71,82
1998,21,395,4447100,41,18,23
1999,21,395,4447200,495,251,244
2000,21,395,4447300,644,317,327
2001,21,395,4447400,284,135,149
2002,21,395,4447500,239,123,116
2003,21,395,4447600,84,40,44
2004,21,395,4447700,0,0,0
2005,21,395,4447800,251,128,123
2006,21,395,4447900,88,47,41
2007,21,395,4448000,248,117,131
2008,21,395,4448100,92,42,50
2009,21,395,4448200,2016,1005,1011
2010,21,395,4448300,630,316,314
2011,21,395,4448400,1254,607,647
2012,21,395,4448500,27,16,11
2013,21,395,4448600,857,417,440
2014,21,395,4448700,361,196,165
2015,21,395,4448800,498,220,278
2016,21,395,4448900,1056,532,524
2017,21,395,4449000,265,132,133
2018,21,395,4449100,1256,622,634
2019,21,395,4449200,680,348,332
2020,21,395,4449300,2764,1343,1421
2021,21,395,4449400,1800,888,912
2022,21,395,4449500,1743,881,862
2023,21,395,4449600,2595,1282,1313
2024,21,395,4449700,887,432,455
2025,21,395,4449800,2669,1358,1311
2026,21,395,4449900,4907,2520,2387
2027,21,395,4450000,1502,736,766
2028,21,395,4450100,1386,680,706
2029,21,395,4450200,140,65,75
2030,21,395,4450300,2178,1079,1099
2031,21,395,4450400,927,466,461
2032,21,395,4450500,2846,1439,1407
2033,21,395,4450600,3086,1538,1548
2034,21,395,4450700,3011,1530,1481
2035,21,395,4450800,1387,680,707
2036,21,395,4450900,769,384,385
2037,21,395,4451000,1501,717,784
2038,21,395,4451100,878,450,428
2039,21,395,4451200,1890,914,976
2040,21,395,4451300,3422,1728,1694
2041,21,395,4451400,1843,938,905
2042,21,395,4451500,2788,1358,1430
2043,21,395,4451600,1120,561,559
2044,21,395,4451700,709,377,332
2045,21,395,4451800,1353,694,659
2046,21,395,4451900,2546,1265,1281
2047,21,395,4452000,1725,870,855
2048,21,395,4452100,0,0,0
2049,21,395,4452200,1145,582,563
2050,21,395,4452300,1958,946,1012
2051,21,395,4452400,864,434,430
2052,21,395,4452500,75,38,37
2053,21,395,4452600,1296,633,663
2054,21,395,4452700,1360,691,669
2055,21,395,4452800,909,443,466
2056,21,395,4452900,464,233,231
2057,21,395,4453000,1793,871,922
2058,21,395,4453100,835,426,409
2059,21,395,4453200,741,342,399
2060,21,395,4453300,190,84,106
2061,21,395,4453400,332,169,163
2062,21,395,4453500,60,38,22
2063,21,395,4453600,138,77,61
2064,21,395,4453700,1261,628,633
2065,21,395,4453800,641,313,328
2066,21,395,4453900,832,384,448
2067,21,395,4454000,0,0,0
2068,21,395,4454100,1000,489,511
2069,21,395,4454200,1623,785,838
2070,21,395,4454300,427,216,211
2071,21,395,4454400,9,3,6
2072,21,395,4454500,106,52,54
2073,21,395,4454600,233,119,114
2074,21,395,4454700,52,27,25
2075,21,395,4454800,23,16,7
2076,21,395,4454900,394,196,198
2077,21,395,4455000,1756,864,892
2078,21,395,4455100,1869,962,907
2079,21,395,4455200,1415,738,677
2080,21,395,4455300,1654,832,822
2081,21,395,4455400,1688,807,881
2082,21,395,4455500,4270,2160,2110
2083,21,395,4455600,998,491,507
2084,21,395,4455700,1669,796,873
2085,21,395,4455800,516,234,282
2086,21,395,4455900,180,96,84
2087,21,395,4456000,100,46,54
2088,21,395,4456100,604,299,305
2089,21,395,4456200,158,80,78
2090,21,395,4456300,129,60,69
2091,21,395,4456400,2243,1079,1164
2092,21,395,4456500,265,130,135
2093,21,395,4456600,1294,628,666
2094,21,395,4456700,1545,769,776
2095,21,395,4456800,1764,877,887
2096,21,395,4456900,1304,676,628
2097,21,395,4457000,1221,605,616
2098,21,395,4457100,1811,920,891
2099,21,395,4457200,151,76,75
2100,21,395,4457300,1985,1004,981
2101,21,395,4457400,1068,540,528
2102,21,395,4457500,1352,660,692
2103,21,395,4457600,2661,1245,1416
2104,21,395,4457700,2243,1116,1127
2105,21,395,4457800,1546,767,779
2106,21,395,4457900,1981,1004,977
2107,21,395,4458000,2373,1170,1203
2108,21,395,4458100,3797,1881,1916
2109,21,395,4458200,1104,540,564
2110,21,395,4458300,993,509,484
2111,21,395,4458400,1624,819,805
2112,21,395,4458500,1699,833,866
2113,21,395,4458600,1484,746,738
2114,21,395,4458700,1401,663,738
2115,21,395,4458800,1030,500,530
2116,21,395,4458900,2187,1081,1106
2117,21,395,4459000,682,357,325
2118,21,395,4459100,307,158,149
2119,21,395,4459200,266,143,123
2120,21,395,4459300,173,93,80
2121,21,395,4459400,1070,544,526
2122,21,395,4459500,984,481,503
2123,21,395,4459600,1083,536,547
2124,21,395,4459700,3809,1933,1876
2125,21,395,4459800,1853,929,924
2126,21,395,4459900,1022,474,548
2127,21,395,4460000,1097,551,546
2128,21,395,4460100,568,277,291
2129,21,395,4460200,888,431,457
2130,21,395,4460300,1070,536,534
2131,21,395,4460400,1809,909,900
2132,21,395,4460500,1973,963,1010
2133,21,395,4460600,1431,714,717
2134,21,395,4460700,789,390,399
2135,21,395,4460800,1036,509,527
2136,21,395,4460900,576,278,298
2137,21,395,4461000,622,302,320
2138,21,395,4461100,76,38,38
2139,21,395,4461200,480,232,248
2140,21,395,4461300,191,92,99
2141,21,395,4461400,1045,519,526
2142,21,395,4461500,517,247,270
2143,21,395,4461600,2164,1060,1104
2144,21,395,4461700,1328,691,637
2145,21,395,4461800,1499,754,745
2146,21,395,4461900,4096,2009,2087
2147,21,395,4462000,2285,1108,1177
2148,21,395,4462100,1101,524,577
2149,21,395,4462200,1085,513,572
2150,21,395,4462300,910,447,463
2151,21,395,4462400,2655,1378,1277
2152,21,395,4462500,2305,1149,1156
2153,21,395,4462600,3410,1594,1816
2154,21,395,4462700,804,373,431
2155,21,395,4462800,1348,671,677
2156,21,395,4462900,2360,1118,1242
2157,21,395,4463000,2363,1156,1207
2158,21,395,4463100,1889,919,970
2159,21,395,4463200,2508,1252,1256
2160,21,395,4463300,2582,1288,1294
2161,21,395,4463400,887,449,438
2162,21,395,4463500,2604,1261,1343
2163,21,395,4463600,115,63,52
2164,21,395,4463700,848,407,441
2165,21,395,4463800,502,232,270
2166,21,395,4463900,3309,1689,1620
2167,21,395,4464000,472,247,225
2168,21,395,4464100,1120,546,574
2169,21,395,4464200,2117,1045,1072
2170,21,395,4464300,1987,996,991
2171,21,395,4464400,1023,495,528
2172,21,395,4464500,672,316,356
2173,21,395,4464600,455,229,226
2174,21,395,4464700,320,144,176
2175,21,395,4464800,885,425,460
2176,21,395,4464900,687,338,349
2177,21,395,4465000,1487,694,793
2178,21,395,4465100,2604,1302,1302
2179,21,395,4465200,1395,672,723
2180,21,395,4465300,1324,636,688
2181,21,395,4465400,4777,2367,2410
2182,21,395,4465500,3813,1903,1910
2183,21,395,4465600,3968,1942,2026
2184,21,395,4465700,365,173,192
2185,21,395,4465800,1657,819,838
2186,21,395,4465900,837,403,434
2187,21,395,4466000,1294,633,661
2188,21,395,4466100,261,120,141
2189,21,395,4466200,1112,529,583
2190,21,395,4466300,1133,527,606
2191,21,395,4466400,1271,636,635
2192,21,395,4466500,229,112,117
2193,21,395,4466600,1660,791,869
2194,21,395,4466700,751,366,385
2195,21,395,4466800,1183,575,608
2196,21,395,4466900,1081,531,550
2197,21,395,4467000,1213,603,610
2198,21,395,4467100,2475,1296,1179
2199,21,395,4467200,1499,732,767
2200,21,395,4467300,981,466,515
2201,21,395,4467400,1873,926,947
2202,21,395,4467500,1021,489,532
2203,21,395,4467600,463,218,245
2204,21,395,4467700,856,409,447
2205,21,395,4467800,1118,565,553
2206,21,395,4467900,2046,982,1064
2207,21,395,4468000,12395,6320,6075
2208,21,395,4468100,4218,2103,2115
2209,21,395,4468200,2997,1469,1528
2210,21,395,4468300,1793,866,927
2211,21,395,4468400,3785,1890,1895
2212,21,395,4468500,3597,1802,1795
2213,21,395,4468600,2365,1141,1224
2214,21,395,4468700,1560,765,795
2215,21,395,4468800,843,422,421
2216,21,395,4468900,527,260,267
2217,21,395,4469000,684,328,356
2218,21,395,4469100,310,174,136
2219,21,395,4469200,702,323,379
2220,21,395,4469300,776,375,401
2221,21,395,4469400,1080,532,548
2222,21,395,4469500,707,331,376
2223,21,395,4469600,412,203,209
2224,21,395,4469700,656,302,354
2225,21,395,4469800,1615,790,825
2226,21,395,4469900,657,317,340
2227,21,395,4470000,1621,829,792
2228,21,395,4470100,785,410,375
2229,21,395,4470200,799,384,415
2230,21,395,4470300,419,209,210
2231,21,395,4470400,0,0,0
2232,21,395,4470500,28,17,11
2233,21,395,4470600,1108,559,549
2234,21,395,4470700,737,361,376
2235,21,395,4470800,996,473,523
