,Statecode,Districtcode,VillageCode,Population,Males,Females
0,21,29,4827700,1005,475,530
1,21,29,4827800,1135,599,536
2,21,29,4827900,1561,771,790
3,21,29,4828000,1384,679,705
4,21,29,4828100,1537,732,805
5,21,29,4828200,443,231,212
6,21,29,4828300,375,179,196
7,21,29,4828400,1129,578,551
8,21,29,4828500,2679,1409,1270
9,21,29,4828600,305,157,148
10,21,29,4828700,1895,961,934
11,21,29,4828800,2141,1114,1027
12,21,29,4828900,878,437,441
13,21,29,4829000,200,95,105
14,21,29,4829100,640,331,309
15,21,29,4829200,6478,3251,3227
16,21,29,4829300,155,75,80
17,21,29,4829400,506,265,241
18,21,29,4829500,1725,894,831
19,21,29,4829600,1605,775,830
20,21,29,4829700,2922,1460,1462
21,21,29,4829800,2606,1313,1293
22,21,29,4829900,2097,1019,1078
23,21,29,4830000,1286,626,660
24,21,29,4830100,1352,685,667
25,21,29,4830200,1510,742,768
26,21,29,4830300,1748,871,877
27,21,29,4830400,653,300,353
28,21,29,4830500,1595,794,801
29,21,29,4830600,545,268,277
30,21,29,4830700,780,394,386
31,21,29,4830800,1892,969,923
32,21,29,4830900,898,452,446
33,21,29,4831000,301,163,138
34,21,29,4831100,1745,860,885
35,21,29,4831200,406,198,208
36,21,29,4831300,723,358,365
37,21,29,4831400,463,257,206
38,21,29,4831500,850,402,448
39,21,29,4831600,828,417,411
40,21,29,4831700,3535,1768,1767
41,21,29,4831800,1181,591,590
42,21,29,4831900,586,267,319
43,21,29,4832000,1161,586,575
44,21,29,4832100,1537,783,754
45,21,29,4832200,772,391,381
46,21,29,4832300,353,181,172
47,21,29,4832400,0,0,0
48,21,29,4832500,2265,1167,1098
49,21,29,4832600,283,153,130
50,21,29,4832700,902,438,464
51,21,29,4832800,1142,552,590
52,21,29,4832900,500,243,257
53,21,29,4833000,2473,1243,1230
54,21,29,4833100,1129,645,484
55,21,29,4833200,0,0,0
56,21,29,4833300,951,486,465
57,21,29,4833400,2355,1188,1167
58,21,29,4833500,1638,811,827
59,21,29,4833600,948,491,457
60,21,29,4833700,439,213,226
61,21,29,4833800,0,0,0
62,21,29,4833900,562,289,273
63,21,29,4834000,0,0,0
64,21,29,4834100,0,0,0
65,21,29,4834200,655,321,334
66,21,29,4834300,552,264,288
67,21,29,4834400,840,418,422
68,21,29,4834500,399,213,186
69,21,29,4834600,646,320,326
70,21,29,4834700,1085,534,551
71,21,29,4834800,283,157,126
72,21,29,4834900,339,197,142
73,21,29,4835000,507,251,256
74,21,29,4835100,1198,578,620
75,21,29,4835200,1012,503,509
76,21,29,4835300,119,66,53
77,21,29,4835400,1503,786,717
78,21,29,4835500,422,219,203
79,21,29,4835600,439,215,224
80,21,29,4835700,2613,1289,1324
81,21,29,4835800,795,404,391
82,21,29,4835900,871,431,440
83,21,29,4836000,439,196,243
84,21,29,4836100,235,105,130
85,21,29,4836200,1717,902,815
86,21,29,4836300,502,250,252
87,21,29,4836400,1057,532,525
88,21,29,4836500,1010,484,526
89,21,29,4836600,78,42,36
90,21,29,4836700,163,80,83
91,21,29,4836800,619,305,314
92,21,29,4836900,1578,802,776
93,21,29,4837000,904,445,459
94,21,29,4837100,1587,777,810
95,21,29,4837200,0,0,0
96,21,29,4837300,437,215,222
97,21,29,4837400,353,184,169
98,21,29,4837500,0,0,0
99,21,29,4837600,2213,1103,1110
100,21,29,4837700,817,404,413
101,21,29,4837800,840,386,454
102,21,29,4837900,466,237,229
103,21,29,4838000,1675,832,843
104,21,29,4838100,751,391,360
105,21,29,4838200,420,204,216
106,21,29,4838300,409,213,196
107,21,29,4838400,1643,848,795
108,21,29,4838500,2782,1370,1412
109,21,29,4838600,1830,914,916
110,21,29,4838700,0,0,0
111,21,29,4838800,1,1,0
112,21,29,4838900,0,0,0
113,21,29,4839000,1410,718,692
114,21,29,4839100,242,124,118
115,21,29,4839200,1113,570,543
116,21,29,4839300,2696,1344,1352
117,21,29,4839400,3095,1589,1506
118,21,29,4839500,1353,662,691
119,21,29,4839600,1185,608,577
120,21,29,4839700,75,43,32
121,21,29,4839800,696,346,350
122,21,29,4839900,58,28,30
123,21,29,4840000,1326,653,673
124,21,29,4840100,197,94,103
125,21,29,4840200,881,463,418
126,21,29,4840300,1077,537,540
127,21,29,4840400,1300,662,638
128,21,29,4840500,654,344,310
129,21,29,4840600,1782,897,885
130,21,29,4840700,1461,767,694
131,21,29,4840800,1616,808,808
132,21,29,4840900,944,462,482
133,21,29,4841000,1322,666,656
134,21,29,4841100,492,251,241
135,21,29,4841200,1585,833,752
136,21,29,4841300,561,277,284
137,21,29,4841400,1682,826,856
138,21,29,4841500,1260,614,646
139,21,29,4841600,816,393,423
140,21,29,4841700,1207,618,589
141,21,29,4841800,1180,578,602
142,21,29,4841900,793,390,403
143,21,29,4842000,449,226,223
144,21,29,4842100,634,317,317
145,21,29,4842200,290,132,158
146,21,29,4842300,359,187,172
147,21,29,4842400,510,235,275
148,21,29,4842500,540,257,283
149,21,29,4842600,734,373,361
150,21,29,4842700,256,117,139
151,21,29,4842800,414,197,217
152,21,29,4842900,5533,2807,2726
153,21,29,4843000,852,410,442
154,21,29,4843100,1551,786,765
155,21,29,4843200,383,183,200
156,21,29,4843300,2811,1407,1404
157,21,29,4843400,1331,635,696
158,21,29,4843500,1802,897,905
159,21,29,4843600,1522,756,766
160,21,29,4843700,1224,615,609
161,21,29,4843800,805,392,413
162,21,29,4843900,1313,639,674
163,21,29,4844000,709,351,358
164,21,29,4844100,1462,717,745
165,21,29,4844200,1495,730,765
166,21,29,4844300,765,376,389
167,21,29,4844400,63,32,31
168,21,29,4844500,9760,5025,4735
169,21,29,4844600,1095,531,564
170,21,29,4844700,692,317,375
171,21,29,4844800,516,241,275
172,21,29,4844900,2930,1477,1453
173,21,29,4845000,828,384,444
174,21,29,4845100,230,107,123
175,21,29,4845200,2019,988,1031
176,21,29,4845300,1639,839,800
177,21,29,4845400,536,270,266
178,21,29,4845500,1424,710,714
179,21,29,4845600,256,113,143
180,21,29,4845700,514,257,257
181,21,29,4845800,1012,524,488
182,21,29,4845900,1302,638,664
183,21,29,4846000,740,373,367
184,21,29,4846100,901,454,447
185,21,29,4846200,1936,1015,921
186,21,29,4846300,3836,1905,1931
187,21,29,4846400,702,345,357
188,21,29,4846500,433,219,214
189,21,29,4846600,572,280,292
190,21,29,4846700,2697,1274,1423
191,21,29,4846800,2164,1074,1090
192,21,29,4846900,2658,1298,1360
193,21,29,4847000,1920,951,969
194,21,29,4847100,1038,503,535
195,21,29,4847200,826,416,410
196,21,29,4847300,1316,647,669
197,21,29,4847400,795,385,410
198,21,29,4847500,540,246,294
199,21,29,4847600,384,168,216
200,21,29,4847700,601,280,321
201,21,29,4847800,315,146,169
202,21,29,4847900,699,305,394
203,21,29,4848000,673,320,353
204,21,29,4848100,767,378,389
205,21,29,4848200,1375,685,690
206,21,29,4848300,1519,783,736
207,21,29,4848400,0,0,0
208,21,29,4848500,288,148,140
209,21,29,4848600,831,400,431
210,21,29,4848700,700,339,361
211,21,29,4848800,1113,533,580
212,21,29,4848900,2817,1435,1382
213,21,29,4849000,1901,955,946
214,21,29,4849100,4174,2112,2062
215,21,29,4849200,1571,844,727
216,21,29,4849300,528,237,291
217,21,29,4849400,621,338,283
218,21,29,4849500,1468,712,756
219,21,29,4849600,544,257,287
220,21,29,4849700,342,158,184
221,21,29,4849800,1500,724,776
222,21,29,4849900,685,328,357
223,21,29,4850000,74,32,42
224,21,29,4850100,1181,534,647
225,21,29,4850200,223,99,124
226,21,29,4850300,298,163,135
227,21,29,4850400,1499,735,764
228,21,29,4850500,1114,536,578
229,21,29,4850600,1509,816,693
230,21,29,4850700,1360,650,710
231,21,29,4850800,694,350,344
232,21,29,4850900,3352,1711,1641
233,21,29,4851000,2868,1377,1491
234,21,29,4851100,717,331,386
235,21,29,4851200,1034,523,511
236,21,29,4851300,229,96,133
237,21,29,4851400,132,65,67
238,21,29,4851500,749,391,358
239,21,29,4851600,118,55,63
240,21,29,4851700,654,320,334
241,21,29,4851800,234,122,112
242,21,29,4851900,157,80,77
243,21,29,4852000,285,155,130
244,21,29,4852100,1503,699,804
245,21,29,4852200,443,224,219
246,21,29,4852300,1924,965,959
247,21,29,4852400,1588,772,816
248,21,29,4852500,936,459,477
249,21,29,4852600,2322,1159,1163
250,21,29,4852700,373,196,177
251,21,29,4852800,1208,615,593
252,21,29,4852900,1555,766,789
253,21,29,4853000,577,316,261
254,21,29,4853100,1085,553,532
255,21,29,4853200,270,127,143
256,21,29,4853300,242,119,123
257,21,29,4853400,323,172,151
258,21,29,4853500,526,264,262
259,21,29,4853600,495,236,259
260,21,29,4853700,711,346,365
261,21,29,4853800,381,190,191
262,21,29,4853900,678,339,339
263,21,29,4854000,3527,1731,1796
264,21,29,4854100,317,159,158
265,21,29,4854200,655,335,320
266,21,29,4854300,493,245,248
267,21,29,4854400,547,283,264
268,21,29,4854500,215,104,111
269,21,29,4854600,416,200,216
270,21,29,4854700,771,363,408
271,21,29,4854800,390,183,207
272,21,29,4854900,611,307,304
273,21,29,4855000,1477,728,749
274,21,29,4855100,774,406,368
275,21,29,4855200,316,150,166
276,21,29,4855300,0,0,0
277,21,29,4855400,0,0,0
278,21,29,4855500,283,128,155
279,21,29,4855600,0,0,0
280,21,29,4855700,213,83,130
281,21,29,4855800,614,292,322
282,21,29,4855900,382,184,198
283,21,29,4856000,0,0,0
284,21,29,4856100,0,0,0
285,21,29,4856200,802,383,419
286,21,29,4856300,0,0,0
287,21,29,4856400,105,47,58
288,21,29,4856500,11,4,7
289,21,29,4856600,216,104,112
290,21,29,4856700,382,183,199
291,21,29,4856800,57,27,30
292,21,29,4856900,73,36,37
293,21,29,4857000,191,99,92
294,21,29,4857100,315,152,163
295,21,29,4857200,313,155,158
296,21,29,4857300,351,176,175
297,21,29,4857400,909,439,470
298,21,29,4857500,1119,550,569
299,21,29,4857600,393,189,204
300,21,29,4857700,157,87,70
301,21,29,4857800,152,78,74
302,21,29,4857900,821,408,413
303,21,29,4858000,177,76,101
304,21,29,4858100,390,181,209
305,21,29,4858200,412,206,206
306,21,29,4858300,887,459,428
307,21,29,4858400,290,153,137
308,21,29,4858500,256,127,129
309,21,29,4858600,317,164,153
310,21,29,4858700,824,412,412
311,21,29,4858800,1019,503,516
312,21,29,4858900,367,183,184
313,21,29,4859000,823,374,449
314,21,29,4859100,285,136,149
315,21,29,4859200,595,304,291
316,21,29,4859300,413,189,224
317,21,29,4859400,728,360,368
318,21,29,4859500,565,264,301
319,21,29,4859600,740,369,371
320,21,29,4859700,248,120,128
321,21,29,4859800,288,141,147
322,21,29,4859900,301,138,163
323,21,29,4860000,491,231,260
324,21,29,4860100,626,328,298
325,21,29,4860200,105,63,42
326,21,29,4860300,0,0,0
327,21,29,4860400,130,64,66
328,21,29,4860500,0,0,0
329,21,29,4860600,0,0,0
330,21,29,4860700,13,8,5
331,21,29,4860800,0,0,0
332,21,29,4860900,0,0,0
333,21,29,4861000,221,86,135
334,21,29,4861100,55,26,29
335,21,29,4861200,292,150,142
336,21,29,4861300,173,87,86
337,21,29,4861400,0,0,0
338,21,29,4861500,1023,510,513
339,21,29,4861600,213,103,110
340,21,29,4861700,251,113,138
341,21,29,4861800,8,2,6
342,21,29,4861900,430,216,214
343,21,29,4862000,1534,757,777
344,21,29,4862100,234,126,108
345,21,29,4862200,196,95,101
346,21,29,4862300,268,143,125
347,21,29,4862400,1556,731,825
348,21,29,4862500,169,90,79
349,21,29,4862600,277,133,144
350,21,29,4862700,188,86,102
351,21,29,4862800,2390,1217,1173
352,21,29,4862900,161,75,86
353,21,29,4863000,1097,550,547
354,21,29,4863100,463,245,218
355,21,29,4863200,785,407,378
356,21,29,4863300,390,182,208
357,21,29,4863400,242,127,115
358,21,29,4863500,969,470,499
359,21,29,4863600,129,63,66
360,21,29,4863700,0,0,0
361,21,29,4863800,373,177,196
362,21,29,4863900,692,328,364
363,21,29,4864000,739,353,386
364,21,29,4864100,1959,969,990
365,21,29,4864200,453,219,234
366,21,29,4864300,60,29,31
367,21,29,4864400,83,39,44
368,21,29,4864500,45,28,17
369,21,29,4864600,404,206,198
370,21,29,4864700,237,124,113
371,21,29,4864800,17,5,12
372,21,29,4864900,905,510,395
373,21,29,4865000,1266,648,618
374,21,29,4865100,986,478,508
375,21,29,4865200,476,224,252
376,21,29,4865300,404,192,212
377,21,29,4865400,521,274,247
378,21,29,4865500,510,265,245
379,21,29,4865600,48,25,23
380,21,29,4865700,317,161,156
381,21,29,4865800,266,128,138
382,21,29,4865900,146,67,79
383,21,29,4866000,1136,552,584
384,21,29,4866100,3316,1648,1668
385,21,29,4866200,296,155,141
386,21,29,4866300,1282,626,656
387,21,29,4866400,254,128,126
388,21,29,4866500,103,44,59
389,21,29,4866600,1460,732,728
390,21,29,4866700,244,119,125
391,21,29,4866800,1695,827,868
392,21,29,4866900,494,258,236
393,21,29,4867000,1904,960,944
394,21,29,4867100,208,99,109
395,21,29,4867200,524,251,273
396,21,29,4867300,417,221,196
397,21,29,4867400,471,246,225
398,21,29,4867500,104,47,57
399,21,29,4867600,290,141,149
400,21,29,4867700,86,34,52
401,21,29,4867800,565,280,285
402,21,29,4867900,196,103,93
403,21,29,4868000,1430,700,730
404,21,29,4868100,905,443,462
405,21,29,4868200,324,150,174
406,21,29,4868300,182,88,94
407,21,29,4868400,251,128,123
408,21,29,4868500,627,296,331
409,21,29,4868600,0,0,0
410,21,29,4868700,1336,650,686
411,21,29,4868800,430,205,225
412,21,29,4868900,524,253,271
413,21,29,4869000,394,191,203
414,21,29,4869100,1495,740,755
415,21,29,4869200,421,192,229
416,21,29,4869300,73,33,40
417,21,29,4869400,235,114,121
418,21,29,4869500,1056,497,559
419,21,29,4869600,80,36,44
420,21,29,4869700,1638,887,751
421,21,29,4869800,1565,756,809
422,21,29,4869900,577,288,289
423,21,29,4870000,1060,511,549
424,21,29,4870100,755,357,398
425,21,29,4870200,1172,564,608
426,21,29,4870300,485,272,213
427,21,29,4870400,301,146,155
428,21,29,4870500,78,42,36
429,21,29,4870600,28,17,11
430,21,29,4870700,591,275,316
431,21,29,4870800,132,64,68
432,21,29,4870900,159,89,70
433,21,29,4871000,587,297,290
434,21,29,4871100,672,316,356
435,21,29,4871200,475,224,251
436,21,29,4871300,1192,590,602
437,21,29,4871400,57,24,33
438,21,29,4871500,911,469,442
439,21,29,4871600,1043,531,512
440,21,29,4871700,121,56,65
441,21,29,4871800,1945,1042,903
442,21,29,4871900,205,102,103
443,21,29,4872000,95,49,46
444,21,29,4872100,229,111,118
445,21,29,4872200,144,68,76
446,21,29,4872300,469,242,227
447,21,29,4872400,3522,1743,1779
448,21,29,4872500,143,68,75
449,21,29,4872600,626,317,309
450,21,29,4872700,503,258,245
451,21,29,4872800,556,275,281
452,21,29,4872900,349,168,181
453,21,29,4873000,1728,879,849
454,21,29,4873100,421,197,224
455,21,29,4873200,621,311,310
456,21,29,4873300,144,63,81
457,21,29,4873400,214,112,102
458,21,29,4873500,417,196,221
459,21,29,4873600,0,0,0
460,21,29,4873700,679,382,297
461,21,29,4873800,40,25,15
462,21,29,4873900,174,89,85
463,21,29,4874000,1440,714,726
464,21,29,4874100,935,453,482
465,21,29,4874200,528,276,252
466,21,29,4874300,331,168,163
467,21,29,4874400,308,161,147
468,21,29,4874500,369,181,188
469,21,29,4874600,361,177,184
470,21,29,4874700,97,47,50
471,21,29,4874800,554,276,278
472,21,29,4874900,568,314,254
473,21,29,4875000,1776,856,920
474,21,29,4875100,634,311,323
475,21,29,4875200,360,173,187
476,21,29,4875300,367,172,195
477,21,29,4875400,361,177,184
478,21,29,4875500,399,213,186
479,21,29,4875600,476,234,242
480,21,29,4875700,1248,626,622
481,21,29,4875800,780,389,391
482,21,29,4875900,917,440,477
483,21,29,4876000,315,161,154
484,21,29,4876100,452,214,238
485,21,29,4876200,338,168,170
486,21,29,4876300,150,57,93
487,21,29,4876400,580,290,290
488,21,29,4876500,437,213,224
489,21,29,4876600,383,181,202
490,21,29,4876700,513,258,255
491,21,29,4876800,117,63,54
492,21,29,4876900,180,87,93
493,21,29,4877000,367,181,186
494,21,29,4877100,296,143,153
495,21,29,4877200,94,47,47
496,21,29,4877300,275,133,142
497,21,29,4877400,45,20,25
498,21,29,4877500,80,43,37
499,21,29,4877600,283,136,147
500,21,29,4877700,257,128,129
501,21,29,4877800,299,150,149
502,21,29,4877900,1356,669,687
503,21,29,4878000,432,184,248
504,21,29,4878100,0,0,0
505,21,29,4878200,772,374,398
506,21,29,4878300,182,87,95
507,21,29,4878400,1485,831,654
508,21,29,4878500,439,219,220
509,21,29,4878600,1624,801,823
510,21,29,4878700,257,113,144
511,21,29,4878800,280,137,143
512,21,29,4878900,665,328,337
513,21,29,4879000,839,397,442
514,21,29,4879100,1217,593,624
515,21,29,4879200,926,476,450
516,21,29,4879300,280,136,144
517,21,29,4879400,157,80,77
518,21,29,4879500,459,221,238
519,21,29,4879600,280,138,142
520,21,29,4879700,122,52,70
521,21,29,4879800,70,39,31
522,21,29,4879900,19,10,9
523,21,29,4880000,94,44,50
524,21,29,4880100,50,20,30
525,21,29,4880200,1278,627,651
526,21,29,4880300,133,53,80
527,21,29,4880400,367,172,195
528,21,29,4880500,1276,609,667
529,21,29,4880600,292,132,160
530,21,29,4880700,699,340,359
531,21,29,4880800,839,400,439
532,21,29,4880900,548,273,275
533,21,29,4881000,118,56,62
534,21,29,4881100,231,114,117
535,21,29,4881200,99,47,52
536,21,29,4881300,141,71,70
537,21,29,4881400,321,150,171
538,21,29,4881500,182,83,99
539,21,29,4881600,120,57,63
540,21,29,4881700,0,0,0
541,21,29,4881800,117,57,60
542,21,29,4881900,59,29,30
543,21,29,4882000,35,16,19
544,21,29,4882100,172,89,83
545,21,29,4882200,129,65,64
546,21,29,4882300,173,83,90
547,21,29,4882400,547,251,296
548,21,29,4882500,1123,553,570
549,21,29,4882600,1011,485,526
550,21,29,4882700,1084,517,567
551,21,29,4882800,692,363,329
552,21,29,4882900,261,119,142
553,21,29,4883000,29,12,17
554,21,29,4883100,197,97,100
555,21,29,4883200,227,110,117
556,21,29,4883300,288,141,147
557,21,29,4883400,2458,1095,1363
558,21,29,4883500,360,197,163
559,21,29,4883600,963,463,500
560,21,29,4883700,1532,750,782
561,21,29,4883800,245,114,131
562,21,29,4883900,501,242,259
563,21,29,4884000,149,67,82
564,21,29,4884100,319,148,171
565,21,29,4884200,368,165,203
566,21,29,4884300,19,11,8
567,21,29,4884400,128,58,70
568,21,29,4884500,35,16,19
569,21,29,4884600,83,34,49
570,21,29,4884700,19,10,9
571,21,29,4884800,353,172,181
572,21,29,4884900,342,180,162
573,21,29,4885000,293,132,161
574,21,29,4885100,369,189,180
575,21,29,4885200,81,36,45
576,21,29,4885300,640,311,329
577,21,29,4885400,126,56,70
578,21,29,4885500,80,42,38
579,21,29,4885600,624,340,284
580,21,29,4885700,112,56,56
581,21,29,4885800,207,107,100
582,21,29,4885900,254,112,142
583,21,29,4886000,669,325,344
584,21,29,4886100,174,94,80
585,21,29,4886200,454,214,240
586,21,29,4886300,36,19,17
587,21,29,4886400,36,19,17
588,21,29,4886500,237,111,126
589,21,29,4886600,284,136,148
590,21,29,4886700,561,285,276
591,21,29,4886800,173,81,92
592,21,29,4886900,468,213,255
593,21,29,4887000,858,447,411
594,21,29,4887100,417,207,210
595,21,29,4887200,270,126,144
596,21,29,4887300,588,350,238
597,21,29,4887400,215,106,109
598,21,29,4887500,398,188,210
599,21,29,4887600,119,49,70
600,21,29,4887700,719,331,388
601,21,29,4887800,1217,593,624
602,21,29,4887900,160,70,90
603,21,29,4888000,1030,470,560
604,21,29,4888100,413,208,205
605,21,29,4888200,311,153,158
606,21,29,4888300,397,188,209
607,21,29,4888400,28,16,12
608,21,29,4888500,81,42,39
609,21,29,4888600,445,221,224
610,21,29,4888700,573,270,303
611,21,29,4888800,545,245,300
612,21,29,4888900,159,79,80
613,21,29,4889000,65,29,36
614,21,29,4889100,578,300,278
615,21,29,4889200,0,0,0
616,21,29,4889300,73,40,33
617,21,29,4889400,111,56,55
618,21,29,4889500,28,13,15
619,21,29,4889600,0,0,0
620,21,29,4889700,73,42,31
621,21,29,4889800,148,76,72
622,21,29,4889900,143,60,83
623,21,29,4890000,122,63,59
624,21,29,4890100,76,33,43
625,21,29,4890200,808,417,391
626,21,29,4890300,1626,797,829
627,21,29,4890400,0,0,0
628,21,29,4890500,486,250,236
629,21,29,4890600,0,0,0
630,21,29,4890700,110,47,63
631,21,29,4890800,2590,1266,1324
632,21,29,4890900,600,320,280
633,21,29,4891000,498,241,257
634,21,29,4891100,164,70,94
635,21,29,4891200,215,102,113
636,21,29,4891300,283,142,141
637,21,29,4891400,143,70,73
638,21,29,4891500,106,53,53
639,21,29,4891600,205,103,102
640,21,29,4891700,452,204,248
641,21,29,4891800,260,136,124
642,21,29,4891900,256,132,124
643,21,29,4892000,204,99,105
644,21,29,4892100,337,164,173
645,21,29,4892200,0,0,0
646,21,29,4892300,244,127,117
647,21,29,4892400,400,187,213
648,21,29,4892500,1122,555,567
649,21,29,4892600,66,43,23
650,21,29,4892700,221,99,122
651,21,29,4892800,203,89,114
652,21,29,4892900,359,184,175
653,21,29,4893000,394,192,202
654,21,29,4893100,197,107,90
655,21,29,4893200,374,190,184
656,21,29,4893300,420,195,225
657,21,29,4893400,1681,841,840
658,21,29,4893500,875,413,462
659,21,29,4893600,5552,2775,2777
660,21,29,4893700,920,440,480
661,21,29,4893800,1035,516,519
662,21,29,4893900,134,65,69
663,21,29,4894000,615,311,304
664,21,29,4894100,253,132,121
665,21,29,4894200,33,19,14
666,21,29,4894300,200,102,98
667,21,29,4894400,376,199,177
668,21,29,4894500,1274,772,502
669,21,29,4894600,55,32,23
670,21,29,4894700,455,208,247
671,21,29,4894800,412,214,198
672,21,29,4894900,224,103,121
673,21,29,4895000,906,463,443
674,21,29,4895100,641,308,333
675,21,29,4895200,430,221,209
676,21,29,4895300,235,119,116
677,21,29,4895400,275,148,127
678,21,29,4895500,785,394,391
679,21,29,4895600,392,195,197
680,21,29,4895700,466,236,230
681,21,29,4895800,400,190,210
682,21,29,4895900,368,192,176
683,21,29,4896000,79,43,36
684,21,29,4896100,248,122,126
685,21,29,4896200,214,102,112
686,21,29,4896300,24,13,11
687,21,29,4896400,207,91,116
688,21,29,4896500,200,110,90
689,21,29,4896600,130,73,57
690,21,29,4896700,257,130,127
691,21,29,4896800,0,0,0
692,21,29,4896900,443,207,236
693,21,29,4897000,635,337,298
694,21,29,4897100,138,66,72
695,21,29,4897200,306,142,164
696,21,29,4897300,392,197,195
697,21,29,4897400,277,136,141
698,21,29,4897500,856,420,436
699,21,29,4897600,1235,614,621
700,21,29,4897700,937,493,444
701,21,29,4897800,808,408,400
702,21,29,4897900,345,164,181
703,21,29,4898000,138,68,70
704,21,29,4898100,552,272,280
705,21,29,4898200,847,429,418
706,21,29,4898300,136,71,65
707,21,29,4898400,223,110,113
708,21,29,4898500,264,121,143
709,21,29,4898600,129,67,62
710,21,29,4898700,176,84,92
711,21,29,4898800,0,0,0
712,21,29,4898900,478,227,251
713,21,29,4899000,542,252,290
714,21,29,4899100,74,32,42
715,21,29,4899200,146,79,67
716,21,29,4899300,221,118,103
717,21,29,4899400,159,74,85
718,21,29,4899500,164,81,83
719,21,29,4899600,157,79,78
720,21,29,4899700,1004,554,450
721,21,29,4899800,327,157,170
722,21,29,4899900,242,118,124
723,21,29,4900000,160,90,70
724,21,29,4900100,149,83,66
725,21,29,4900200,160,76,84
726,21,29,4900300,408,191,217
727,21,29,4900400,88,39,49
728,21,29,4900500,148,75,73
729,21,29,4900600,150,74,76
730,21,29,4900700,417,204,213
731,21,29,4900800,314,155,159
732,21,29,4900900,12,8,4
733,21,29,4901000,0,0,0
734,21,29,4901100,117,65,52
735,21,29,4901200,161,86,75
736,21,29,4901300,157,86,71
737,21,29,4901400,134,74,60
738,21,29,4901500,207,86,121
739,21,29,4901600,428,219,209
740,21,29,4901700,111,65,46
741,21,29,4901800,211,106,105
742,21,29,4901900,288,132,156
743,21,29,4902000,827,413,414
744,21,29,4902100,200,90,110
745,21,29,4902200,483,235,248
746,21,29,4902300,174,90,84
747,21,29,4902400,541,261,280
748,21,29,4902500,355,176,179
749,21,29,4902600,260,126,134
750,21,29,4902700,454,230,224
751,21,29,4902800,300,151,149
752,21,29,4902900,2820,1336,1484
753,21,29,4903000,1541,754,787
754,21,29,4903100,0,0,0
755,21,29,4903200,55,25,30
756,21,29,4903300,1858,1003,855
757,21,29,4903400,416,212,204
758,21,29,4903500,2951,1434,1517
759,21,29,4903600,1140,556,584
760,21,29,4903700,190,91,99
761,21,29,4903800,164,73,91
762,21,29,4903900,1115,550,565
763,21,29,4904000,437,208,229
764,21,29,4904100,1562,812,750
765,21,29,4904200,718,358,360
766,21,29,4904300,197,94,103
767,21,29,4904400,3568,1850,1718
768,21,29,4904500,179,89,90
769,21,29,4904600,453,227,226
770,21,29,4904700,2835,1355,1480
771,21,29,4904800,96,42,54
772,21,29,4904900,150,80,70
773,21,29,4905000,306,133,173
774,21,29,4905100,385,179,206
775,21,29,4905200,132,70,62
776,21,29,4905300,739,366,373
777,21,29,4905400,665,319,346
778,21,29,4905500,2081,1042,1039
779,21,29,4905600,230,105,125
780,21,29,4905700,741,329,412
781,21,29,4905800,381,189,192
782,21,29,4905900,149,79,70
783,21,29,4906000,52,27,25
784,21,29,4906100,461,234,227
785,21,29,4906200,81,39,42
786,21,29,4906300,189,89,100
787,21,29,4906400,300,158,142
788,21,29,4906500,200,99,101
789,21,29,4906600,165,84,81
790,21,29,4906700,267,136,131
791,21,29,4906800,1243,600,643
792,21,29,4906900,1732,818,914
793,21,29,4907000,439,237,202
794,21,29,4907100,655,320,335
795,21,29,4907200,515,256,259
796,21,29,4907300,226,110,116
797,21,29,4907400,1170,579,591
798,21,29,4907500,1386,653,733
799,21,29,4907600,616,275,341
800,21,29,4907700,152,74,78
801,21,29,4907800,205,94,111
802,21,29,4907900,595,289,306
803,21,29,4908000,1365,685,680
804,21,29,4908100,1299,627,672
805,21,29,4908200,1745,842,903
806,21,29,4908300,133,64,69
807,21,29,4908400,773,367,406
808,21,29,4908500,603,316,287
809,21,29,4908600,447,224,223
810,21,29,4908700,1105,547,558
811,21,29,4908800,81,47,34
812,21,29,4908900,281,143,138
813,21,29,4909000,206,99,107
814,21,29,4909100,188,97,91
815,21,29,4909200,735,385,350
816,21,29,4909300,383,183,200
817,21,29,4909400,1476,717,759
818,21,29,4909500,258,128,130
819,21,29,4909600,420,188,232
820,21,29,4909700,1820,876,944
821,21,29,4909800,516,270,246
822,21,29,4909900,304,153,151
823,21,29,4910000,49,28,21
824,21,29,4910100,119,53,66
825,21,29,4910200,432,222,210
826,21,29,4910300,1191,580,611
827,21,29,4910400,967,438,529
828,21,29,4910500,1598,771,827
829,21,29,4910600,383,181,202
830,21,29,4910700,174,81,93
831,21,29,4910800,886,525,361
832,21,29,4910900,176,86,90
833,21,29,4911000,241,119,122
834,21,29,4911100,435,234,201
835,21,29,4911200,97,40,57
836,21,29,4911300,345,179,166
837,21,29,4911400,1478,600,878
838,21,29,4911500,273,134,139
839,21,29,4911600,1814,907,907
840,21,29,4911700,197,94,103
841,21,29,4911800,1776,897,879
842,21,29,4911900,677,346,331
843,21,29,4912000,223,111,112
844,21,29,4912100,1042,502,540
845,21,29,4912200,208,91,117
846,21,29,4912300,0,0,0
847,21,29,4912400,486,266,220
848,21,29,4912500,445,205,240
849,21,29,4912600,2893,1480,1413
850,21,29,4912700,350,165,185
851,21,29,4912800,78,37,41
852,21,29,4912900,150,64,86
853,21,29,4913000,572,276,296
854,21,29,4913100,223,107,116
855,21,29,4913200,390,191,199
856,21,29,4913300,404,191,213
857,21,29,4913400,187,105,82
858,21,29,4913500,365,187,178
859,21,29,4913600,402,196,206
860,21,29,4913700,2153,1029,1124
861,21,29,4913800,550,266,284
862,21,29,4913900,254,133,121
863,21,29,4914000,224,97,127
864,21,29,4914100,1103,560,543
865,21,29,4914200,329,149,180
866,21,29,4914300,96,40,56
867,21,29,4914400,117,59,58
868,21,29,4914500,261,128,133
869,21,29,4914600,141,65,76
870,21,29,4914700,237,129,108
871,21,29,4914800,1500,743,757
872,21,29,4914900,288,132,156
873,21,29,4915000,662,309,353
874,21,29,4915100,389,195,194
875,21,29,4915200,771,363,408
876,21,29,4915300,1387,747,640
877,21,29,4915400,182,106,76
878,21,29,4915500,852,413,439
879,21,29,4915600,7713,3908,3805
880,21,29,4915700,117,56,61
881,21,29,4915800,1541,697,844
882,21,29,4915900,546,297,249
883,21,29,4916000,808,438,370
884,21,29,4916100,168,80,88
885,21,29,4916200,188,94,94
886,21,29,4916300,1547,735,812
887,21,29,4916400,542,260,282
888,21,29,4916500,663,311,352
889,21,29,4916600,386,187,199
890,21,29,4916700,459,243,216
891,21,29,4916800,75,40,35
892,21,29,4916900,20,10,10
893,21,29,4917000,252,126,126
894,21,29,4917100,816,386,430
895,21,29,4917200,764,402,362
896,21,29,4917300,260,118,142
897,21,29,4917400,55,29,26
898,21,29,4917500,256,122,134
899,21,29,4917600,246,112,134
900,21,29,4917700,758,385,373
901,21,29,4917800,152,79,73
902,21,29,4917900,747,360,387
903,21,29,4918000,767,382,385
904,21,29,4918100,410,196,214
905,21,29,4918200,273,142,131
906,21,29,4918300,1897,910,987
907,21,29,4918400,1221,595,626
908,21,29,4918500,881,429,452
909,21,29,4918600,943,500,443
910,21,29,4918700,953,470,483
911,21,29,4918800,963,431,532
912,21,29,4918900,288,129,159
913,21,29,4919000,1029,492,537
914,21,29,4919100,276,140,136
915,21,29,4919200,740,349,391
916,21,29,4919300,223,106,117
917,21,29,4919400,169,87,82
918,21,29,4919500,357,179,178
919,21,29,4919600,0,0,0
920,21,29,4919700,437,204,233
921,21,29,4919800,463,260,203
922,21,29,4919900,444,213,231
923,21,29,4920000,258,128,130
924,21,29,4920100,314,153,161
925,21,29,4920200,174,91,83
926,21,29,4920300,338,143,195
927,21,29,4920400,142,66,76
928,21,29,4920500,420,200,220
929,21,29,4920600,237,136,101
930,21,29,4920700,153,71,82
931,21,29,4920800,124,60,64
932,21,29,4920900,553,281,272
933,21,29,4921000,110,47,63
934,21,29,4921100,0,0,0
935,21,29,4921200,440,198,242
936,21,29,4921300,81,39,42
937,21,29,4921400,457,205,252
938,21,29,4921500,781,392,389
939,21,29,4921600,284,151,133
940,21,29,4921700,236,107,129
941,21,29,4921800,234,113,121
942,21,29,4921900,858,430,428
943,21,29,4922000,0,0,0
944,21,29,4922100,0,0,0
945,21,29,4922200,540,304,236
946,21,29,4922300,191,91,100
947,21,29,4922400,780,378,402
948,21,29,4922500,252,127,125
949,21,29,4922600,0,0,0
950,21,29,4922700,137,64,73
951,21,29,4922800,764,402,362
952,21,29,4922900,329,149,180
953,21,29,4923000,197,95,102
954,21,29,4923100,4,2,2
955,21,29,4923200,462,236,226
956,21,29,4923300,237,111,126
957,21,29,4923400,1200,598,602
958,21,29,4923500,248,129,119
959,21,29,4923600,1359,639,720
960,21,29,4923700,307,143,164
961,21,29,4923800,522,272,250
962,21,29,4923900,448,220,228
963,21,29,4924000,281,143,138
964,21,29,4924100,1189,562,627
965,21,29,4924200,433,222,211
966,21,29,4924300,468,227,241
967,21,29,4924400,190,104,86
968,21,29,4924500,111,45,66
969,21,29,4924600,1341,681,660
970,21,29,4924700,577,296,281
971,21,29,4924800,1675,754,921
972,21,29,4924900,835,431,404
973,21,29,4925000,297,158,139
974,21,29,4925100,469,233,236
975,21,29,4925200,417,204,213
976,21,29,4925300,296,155,141
977,21,29,4925400,390,195,195
978,21,29,4925500,112,56,56
979,21,29,4925600,971,533,438
980,21,29,4925700,289,140,149
981,21,29,4925800,0,0,0
982,21,29,4925900,514,265,249
983,21,29,4926000,359,179,180
984,21,29,4926100,0,0,0
985,21,29,4926200,896,467,429
986,21,29,4926300,801,416,385
987,21,29,4926400,0,0,0
988,21,29,4926500,112,59,53
989,21,29,4926600,412,208,204
990,21,29,4926700,179,81,98
991,21,29,4926800,794,416,378
992,21,29,4926900,133,70,63
993,21,29,4927000,516,251,265
994,21,29,4927100,289,141,148
995,21,29,4927200,501,245,256
996,21,29,4927300,179,83,96
997,21,29,4927400,203,102,101
998,21,29,4927500,241,117,124
999,21,29,4927600,0,0,0
1000,21,29,4927700,237,127,110
1001,21,29,4927800,95,43,52
1002,21,29,4927900,267,128,139
1003,21,29,4928000,66,32,34
1004,21,29,4928100,91,48,43
1005,21,29,4928200,196,96,100
1006,21,29,4928300,157,75,82
1007,21,29,4928400,152,81,71
1008,21,29,4928500,141,70,71
1009,21,29,4928600,0,0,0
1010,21,29,4928700,590,299,291
1011,21,29,4928800,80,37,43
1012,21,29,4928900,213,152,61
1013,21,29,4929000,75,40,35
1014,21,29,4929100,203,95,108
1015,21,29,4929200,111,50,61
1016,21,29,4929300,79,39,40
1017,21,29,4929400,377,191,186
1018,21,29,4929500,564,280,284
1019,21,29,4929600,298,140,158
1020,21,29,4929700,155,73,82
1021,21,29,4929800,342,172,170
1022,21,29,4929900,153,81,72
1023,21,29,4930000,190,89,101
1024,21,29,4930100,180,79,101
1025,21,29,4930200,459,212,247
1026,21,29,4930300,632,306,326
1027,21,29,4930400,89,40,49
1028,21,29,4930500,1235,587,648
1029,21,29,4930600,2144,1051,1093
1030,21,29,4930700,1401,655,746
1031,21,29,4930800,1440,711,729
1032,21,29,4930900,493,223,270
1033,21,29,4931000,311,138,173
1034,21,29,4931100,149,71,78
1035,21,29,4931200,70,34,36
1036,21,29,4931300,174,80,94
1037,21,29,4931400,224,97,127
1038,21,29,4931500,264,126,138
1039,21,29,4931600,267,138,129
1040,21,29,4931700,4493,2294,2199
1041,21,29,4931800,703,330,373
1042,21,29,4931900,226,106,120
1043,21,29,4932000,173,83,90
1044,21,29,4932100,253,110,143
1045,21,29,4932200,183,79,104
1046,21,29,4932300,314,148,166
1047,21,29,4932400,338,163,175
1048,21,29,4932500,453,241,212
1049,21,29,4932600,430,214,216
1050,21,29,4932700,687,308,379
1051,21,29,4932800,275,136,139
1052,21,29,4932900,583,272,311
1053,21,29,4933000,359,173,186
1054,21,29,4933100,523,270,253
1055,21,29,4933200,671,337,334
1056,21,29,4933300,242,121,121
1057,21,29,4933400,666,338,328
1058,21,29,4933500,378,190,188
1059,21,29,4933600,172,83,89
1060,21,29,4933700,526,266,260
1061,21,29,4933800,114,52,62
1062,21,29,4933900,44,21,23
1063,21,29,4934000,398,214,184
1064,21,29,4934100,241,114,127
1065,21,29,4934200,150,66,84
1066,21,29,4934300,183,84,99
1067,21,29,4934400,654,320,334
1068,21,29,4934500,155,73,82
1069,21,29,4934600,40,17,23
1070,21,29,4934700,424,213,211
1071,21,29,4934800,553,274,279
1072,21,29,4934900,236,117,119
1073,21,29,4935000,808,392,416
1074,21,29,4935100,350,167,183
1075,21,29,4935200,392,182,210
1076,21,29,4935300,163,78,85
1077,21,29,4935400,562,274,288
1078,21,29,4935500,1177,560,617
1079,21,29,4935600,213,106,107
1080,21,29,4935700,164,80,84
1081,21,29,4935800,821,390,431
1082,21,29,4935900,635,323,312
1083,21,29,4936000,142,70,72
1084,21,29,4936100,330,184,146
1085,21,29,4936200,148,70,78
1086,21,29,4936300,418,205,213
1087,21,29,4936400,0,0,0
1088,21,29,4936500,449,231,218
1089,21,29,4936600,137,68,69
1090,21,29,4936700,404,195,209
1091,21,29,4936800,214,103,111
1092,21,29,4936900,381,189,192
1093,21,29,4937000,0,0,0
1094,21,29,4937100,50,17,33
1095,21,29,4937200,301,152,149
1096,21,29,4937300,59,35,24
1097,21,29,4937400,447,230,217
1098,21,29,4937500,353,168,185
1099,21,29,4937600,64,29,35
1100,21,29,4937700,453,198,255
1101,21,29,4937800,466,244,222
1102,21,29,4937900,1003,492,511
1103,21,29,4938000,260,188,72
1104,21,29,4938100,177,79,98
1105,21,29,4938200,245,119,126
1106,21,29,4938300,179,71,108
1107,21,29,4938400,262,122,140
1108,21,29,4938500,454,234,220
1109,21,29,4938600,0,0,0
1110,21,29,4938700,639,327,312
1111,21,29,4938800,363,181,182
1112,21,29,4938900,151,67,84
1113,21,29,4939000,281,132,149
1114,21,29,4939100,687,339,348
1115,21,29,4939200,416,211,205
1116,21,29,4939300,242,120,122
1117,21,29,4939400,134,66,68
1118,21,29,4939500,345,161,184
1119,21,29,4939600,212,111,101
1120,21,29,4939700,167,76,91
1121,21,29,4939800,506,245,261
1122,21,29,4939900,47,19,28
1123,21,29,4940000,257,134,123
1124,21,29,4940100,288,141,147
1125,21,29,4940200,71,40,31
1126,21,29,4940300,432,214,218
1127,21,29,4940400,557,251,306
1128,21,29,4940500,694,353,341
1129,21,29,4940600,694,335,359
1130,21,29,4940700,187,96,91
1131,21,29,4940800,910,445,465
1132,21,29,4940900,333,150,183
1133,21,29,4941000,1453,731,722
1134,21,29,4941100,765,355,410
1135,21,29,4941200,261,128,133
1136,21,29,4941300,407,189,218
1137,21,29,4941400,251,133,118
1138,21,29,4941500,1546,775,771
1139,21,29,4941600,297,149,148
1140,21,29,4941700,932,444,488
1141,21,29,4941800,1893,921,972
1142,21,29,4941900,2522,1338,1184
1143,21,29,4942000,1725,895,830
1144,21,29,4942100,1145,572,573
1145,21,29,4942200,2471,1204,1267
1146,21,29,4942300,2713,1378,1335
1147,21,29,4942400,1003,513,490
1148,21,29,4942500,849,420,429
1149,21,29,4942600,1481,730,751
1150,21,29,4942700,438,215,223
1151,21,29,4942800,1095,517,578
1152,21,29,4942900,353,164,189
1153,21,29,4943000,382,191,191
1154,21,29,4943100,1012,485,527
1155,21,29,4943200,905,428,477
1156,21,29,4943300,351,200,151
1157,21,29,4943400,4105,2037,2068
1158,21,29,4943500,1383,701,682
1159,21,29,4943600,8667,4974,3693
1160,21,29,4943700,1251,618,633
1161,21,29,4943800,298,153,145
1162,21,29,4943900,440,208,232
1163,21,29,4944000,114,47,67
1164,21,29,4944100,132,70,62
1165,21,29,4944200,542,267,275
1166,21,29,4944300,1067,521,546
1167,21,29,4944400,797,369,428
1168,21,29,4944500,262,119,143
1169,21,29,4944600,1185,600,585
1170,21,29,4944700,307,149,158
1171,21,29,4944800,206,103,103
1172,21,29,4944900,56,29,27
1173,21,29,4945000,222,111,111
1174,21,29,4945100,150,68,82
1175,21,29,4945200,141,67,74
1176,21,29,4945300,264,126,138
1177,21,29,4945400,0,0,0
1178,21,29,4945500,323,152,171
1179,21,29,4945600,103,49,54
1180,21,29,4945700,126,60,66
1181,21,29,4945800,449,234,215
1182,21,29,4945900,168,71,97
1183,21,29,4946000,412,213,199
1184,21,29,4946100,730,339,391
1185,21,29,4946200,1061,501,560
1186,21,29,4946300,965,468,497
1187,21,29,4946400,2148,1058,1090
1188,21,29,4946500,635,297,338
1189,21,29,4946600,533,252,281
1190,21,29,4946700,208,105,103
1191,21,29,4946800,603,277,326
1192,21,29,4946900,306,140,166
1193,21,29,4947000,122,63,59
1194,21,29,4947100,1020,511,509
1195,21,29,4947200,662,368,294
1196,21,29,4947300,227,113,114
1197,21,29,4947400,160,87,73
1198,21,29,4947500,0,0,0
1199,21,29,4947600,234,121,113
1200,21,29,4947700,134,63,71
1201,21,29,4947800,56,27,29
1202,21,29,4947900,454,224,230
1203,21,29,4948000,0,0,0
1204,21,29,4948100,191,110,81
1205,21,29,4948200,198,80,118
1206,21,29,4948300,747,347,400
1207,21,29,4948400,2332,1262,1070
1208,21,29,4948500,2109,1108,1001
1209,21,29,4948600,1983,977,1006
1210,21,29,4948700,2191,1104,1087
1211,21,29,4948800,1453,746,707
1212,21,29,4948900,878,408,470
1213,21,29,4949000,251,126,125
1214,21,29,4949100,542,265,277
1215,21,29,4949200,590,308,282
1216,21,29,4949300,992,487,505
1217,21,29,4949400,325,160,165
1218,21,29,4949500,972,378,594
1219,21,29,4949600,1166,572,594
1220,21,29,4949700,320,151,169
1221,21,29,4949800,1308,762,546
1222,21,29,4949900,304,143,161
1223,21,29,4950000,619,292,327
1224,21,29,4950100,5337,2721,2616
1225,21,29,4950200,1939,980,959
1226,21,29,4950300,272,134,138
1227,21,29,4950400,272,120,152
1228,21,29,4950500,547,282,265
1229,21,29,4950600,196,89,107
1230,21,29,4950700,454,242,212
1231,21,29,4950800,191,103,88
1232,21,29,4950900,595,304,291
1233,21,29,4951000,505,250,255
1234,21,29,4951100,394,197,197
1235,21,29,4951200,397,198,199
1236,21,29,4951300,544,281,263
1237,21,29,4951400,1275,638,637
1238,21,29,4951500,1124,532,592
1239,21,29,4951600,203,95,108
1240,21,29,4951700,55,25,30
1241,21,29,4951800,422,199,223
1242,21,29,4951900,804,401,403
1243,21,29,4952000,2635,1360,1275
1244,21,29,4952100,1091,538,553
1245,21,29,4952200,967,470,497
1246,21,29,4952300,1442,711,731
1247,21,29,4952400,1041,519,522
1248,21,29,4952500,394,190,204
1249,21,29,4952600,2511,1235,1276
1250,21,29,4952700,211,111,100
1251,21,29,4952800,189,90,99
1252,21,29,4952900,315,164,151
1253,21,29,4953000,422,211,211
1254,21,29,4953100,708,346,362
1255,21,29,4953200,137,60,77
1256,21,29,4953300,0,0,0
1257,21,29,4953400,3476,1736,1740
1258,21,29,4953500,466,237,229
1259,21,29,4953600,0,0,0
1260,21,29,4953700,578,276,302
1261,21,29,4953800,0,0,0
1262,21,29,4953900,2554,1400,1154
1263,21,29,4954000,338,179,159
1264,21,29,4954100,1131,588,543
1265,21,29,4954200,57,32,25
1266,21,29,4954300,189,90,99
1267,21,29,4954400,490,245,245
1268,21,29,4954500,159,78,81
1269,21,29,4954600,398,176,222
1270,21,29,4954700,537,258,279
1271,21,29,4954800,796,393,403
1272,21,29,4954900,622,383,239
1273,21,29,4955000,347,176,171
1274,21,29,4955100,438,227,211
1275,21,29,4955200,1520,722,798
1276,21,29,4955300,3433,1817,1616
1277,21,29,4955400,3259,1656,1603
1278,21,29,4955500,1021,467,554
1279,21,29,4955600,2203,1062,1141
1280,21,29,4955700,955,460,495
1281,21,29,4955800,2223,1127,1096
1282,21,29,4955900,3273,1597,1676
1283,21,29,4956000,1317,649,668
1284,21,29,4956100,478,260,218
1285,21,29,4956200,1580,764,816
1286,21,29,4956300,969,469,500
1287,21,29,4956400,1486,732,754
1288,21,29,4956500,528,277,251
1289,21,29,4956600,661,330,331
1290,21,29,4956700,1748,915,833
1291,21,29,4956800,887,447,440
1292,21,29,4956900,3399,1654,1745
1293,21,29,4957000,870,437,433
1294,21,29,4957100,641,336,305
1295,21,29,4957200,146,76,70
1296,21,29,4957300,91,45,46
1297,21,29,4957400,336,169,167
1298,21,29,4957500,663,345,318
1299,21,29,4957600,317,163,154
1300,21,29,4957700,94,49,45
1301,21,29,4957800,25,12,13
1302,21,29,4957900,140,67,73
1303,21,29,4958000,106,56,50
1304,21,29,4958100,142,80,62
1305,21,29,4958200,803,406,397
1306,21,29,4958300,0,0,0
1307,21,29,4958400,560,307,253
1308,21,29,4958500,0,0,0
1309,21,29,4958600,290,142,148
1310,21,29,4958700,0,0,0
1311,21,29,4958800,68,33,35
1312,21,29,4958900,538,288,250
1313,21,29,4959000,268,134,134
1314,21,29,4959100,694,349,345
1315,21,29,4959200,1370,704,666
1316,21,29,4959300,179,81,98
1317,21,29,4959400,1644,774,870
1318,21,29,4959500,233,112,121
1319,21,29,4959600,696,342,354
1320,21,29,4959700,204,97,107
1321,21,29,4959800,333,165,168
1322,21,29,4959900,83,42,41
1323,21,29,4960000,198,91,107
1324,21,29,4960100,60,27,33
1325,21,29,4960200,506,297,209
1326,21,29,4960300,42,25,17
1327,21,29,4960400,143,68,75
1328,21,29,4960500,350,174,176
1329,21,29,4960600,0,0,0
1330,21,29,4960700,369,181,188
1331,21,29,4960800,1146,577,569
1332,21,29,4960900,679,347,332
1333,21,29,4961000,102,40,62
1334,21,29,4961100,607,284,323
1335,21,29,4961200,462,230,232
1336,21,29,4961300,169,87,82
1337,21,29,4961400,471,241,230
1338,21,29,4961500,177,94,83
1339,21,29,4961600,27,13,14
1340,21,29,4961700,284,136,148
1341,21,29,4961800,284,130,154
1342,21,29,4961900,493,242,251
1343,21,29,4962000,208,96,112
1344,21,29,4962100,177,80,97
1345,21,29,4962200,546,274,272
1346,21,29,4962300,153,76,77
1347,21,29,4962400,160,67,93
1348,21,29,4962500,205,99,106
1349,21,29,4962600,1468,595,873
1350,21,29,4962700,95,44,51
1351,21,29,4962800,657,342,315
1352,21,29,4962900,835,408,427
1353,21,29,4963000,199,91,108
1354,21,29,4963100,383,199,184
1355,21,29,4963200,794,409,385
1356,21,29,4963300,0,0,0
1357,21,29,4963400,533,274,259
1358,21,29,4963500,0,0,0
1359,21,29,4963600,142,73,69
1360,21,29,4963700,290,141,149
1361,21,29,4963800,291,152,139
1362,21,29,4963900,422,212,210
1363,21,29,4964000,258,127,131
1364,21,29,4964100,408,195,213
1365,21,29,4964200,963,457,506
1366,21,29,4964300,1808,918,890
1367,21,29,4964400,1006,452,554
1368,21,29,4964500,314,151,163
1369,21,29,4964600,679,338,341
1370,21,29,4964700,725,336,389
1371,21,29,4964800,531,267,264
1372,21,29,4964900,1551,759,792
1373,21,29,4965000,2696,1318,1378
1374,21,29,4965100,927,483,444
1375,21,29,4965200,48,32,16
1376,21,29,4965300,2904,1431,1473
1377,21,29,4965400,1820,928,892
1378,21,29,4965500,1204,621,583
1379,21,29,4965600,998,483,515
1380,21,29,4965700,857,421,436
1381,21,29,4965800,1790,883,907
1382,21,29,4965900,1796,855,941
1383,21,29,4966000,367,192,175
1384,21,29,4966100,307,155,152
1385,21,29,4966200,112,59,53
1386,21,29,4966300,1383,673,710
1387,21,29,4966400,959,525,434
1388,21,29,4966500,958,485,473
1389,21,29,4966600,1780,889,891
1390,21,29,4966700,220,103,117
1391,21,29,4966800,461,230,231
1392,21,29,4966900,538,264,274
1393,21,29,4967000,1178,562,616
1394,21,29,4967100,655,315,340
1395,21,29,4967200,515,251,264
1396,21,29,4967300,138,66,72
1397,21,29,4967400,226,106,120
1398,21,29,4967500,468,220,248
1399,21,29,4967600,528,251,277
1400,21,29,4967700,149,75,74
1401,21,29,4967800,969,478,491
1402,21,29,4967900,0,0,0
1403,21,29,4968000,587,329,258
1404,21,29,4968100,1395,712,683
1405,21,29,4968200,1782,897,885
1406,21,29,4968300,103,50,53
1407,21,29,4968400,1168,662,506
1408,21,29,4968500,457,226,231
1409,21,29,4968600,669,309,360
1410,21,29,4968700,911,490,421
1411,21,29,4968800,314,157,157
1412,21,29,4968900,824,407,417
1413,21,29,4969000,33,18,15
1414,21,29,4969100,361,159,202
1415,21,29,4969200,308,152,156
1416,21,29,4969300,83,37,46
1417,21,29,4969400,113,50,63
1418,21,29,4969500,106,57,49
1419,21,29,4969600,213,106,107
1420,21,29,4969700,498,246,252
1421,21,29,4969800,0,0,0
1422,21,29,4969900,35,20,15
1423,21,29,4970000,617,296,321
1424,21,29,4970100,163,80,83
1425,21,29,4970200,124,56,68
1426,21,29,4970300,468,239,229
1427,21,29,4970400,0,0,0
1428,21,29,4970500,896,430,466
1429,21,29,4970600,258,126,132
1430,21,29,4970700,196,95,101
1431,21,29,4970800,0,0,0
1432,21,29,4970900,102,55,47
1433,21,29,4971000,78,39,39
1434,21,29,4971100,0,0,0
1435,21,29,4971200,71,32,39
1436,21,29,4971300,68,34,34
1437,21,29,4971400,264,113,151
1438,21,29,4971500,68,33,35
1439,21,29,4971600,153,70,83
1440,21,29,4971700,112,59,53
1441,21,29,4971800,365,164,201
1442,21,29,4971900,55,28,27
1443,21,29,4972000,553,264,289
1444,21,29,4972100,679,353,326
1445,21,29,4972200,432,204,228
1446,21,29,4972300,119,52,67
1447,21,29,4972400,112,59,53
1448,21,29,4972500,40,18,22
1449,21,29,4972600,685,363,322
1450,21,29,4972700,507,245,262
1451,21,29,4972800,305,165,140
1452,21,29,4972900,1257,647,610
1453,21,29,4973000,416,197,219
1454,21,29,4973100,740,358,382
1455,21,29,4973200,493,245,248
1456,21,29,4973300,284,129,155
1457,21,29,4973400,113,48,65
1458,21,29,4973500,90,44,46
1459,21,29,4973600,248,112,136
1460,21,29,4973700,325,157,168
1461,21,29,4973800,219,105,114
1462,21,29,4973900,275,137,138
1463,21,29,4974000,307,142,165
1464,21,29,4974100,770,385,385
1465,21,29,4974200,205,102,103
1466,21,29,4974300,87,44,43
1467,21,29,4974400,544,268,276
1468,21,29,4974500,146,76,70
1469,21,29,4974600,689,337,352
1470,21,29,4974700,200,95,105
1471,21,29,4974800,239,129,110
1472,21,29,4974900,2387,1215,1172
1473,21,29,4975000,0,0,0
1474,21,29,4975100,197,91,106
1475,21,29,4975200,0,0,0
1476,21,29,4975300,418,195,223
1477,21,29,4975400,733,366,367
1478,21,29,4975500,120,59,61
1479,21,29,4975600,2165,1066,1099
1480,21,29,4975700,2326,1192,1134
1481,21,29,4975800,1317,661,656
1482,21,29,4975900,0,0,0
1483,21,29,4976000,207,104,103
1484,21,29,4976100,133,58,75
1485,21,29,4976200,182,160,22
1486,21,29,4976300,1511,763,748
1487,21,29,4976400,260,126,134
1488,21,29,4976500,544,262,282
1489,21,29,4976600,2237,1111,1126
1490,21,29,4976700,233,121,112
1491,21,29,4976800,0,0,0
1492,21,29,4976900,476,226,250
1493,21,29,4977000,70,28,42
1494,21,29,4977100,143,70,73
1495,21,29,4977200,143,66,77
1496,21,29,4977300,340,165,175
1497,21,29,4977400,639,329,310
1498,21,29,4977500,226,103,123
1499,21,29,4977600,311,164,147
1500,21,29,4977700,739,418,321
1501,21,29,4977800,182,88,94
1502,21,29,4977900,122,64,58
1503,21,29,4978000,112,53,59
1504,21,29,4978100,96,49,47
1505,21,29,4978200,214,102,112
1506,21,29,4978300,117,56,61
1507,21,29,4978400,689,361,328
1508,21,29,4978500,315,150,165
1509,21,29,4978600,773,370,403
1510,21,29,4978700,571,293,278
1511,21,29,4978800,1342,648,694
1512,21,29,4978900,267,118,149
1513,21,29,4979000,281,142,139
1514,21,29,4979100,373,180,193
1515,21,29,4979200,164,83,81
1516,21,29,4979300,426,189,237
1517,21,29,4979400,707,336,371
1518,21,29,4979500,525,262,263
1519,21,29,4979600,576,270,306
1520,21,29,4979700,552,248,304
1521,21,29,4979800,630,317,313
1522,21,29,4979900,813,414,399
1523,21,29,4980000,457,212,245
1524,21,29,4980100,189,94,95
1525,21,29,4980200,227,96,131
1526,21,29,4980300,0,0,0
1527,21,29,4980400,167,86,81
1528,21,29,4980500,75,36,39
1529,21,29,4980600,717,350,367
1530,21,29,4980700,137,55,82
1531,21,29,4980800,298,134,164
1532,21,29,4980900,91,48,43
1533,21,29,4981000,368,164,204
1534,21,29,4981100,1066,502,564
1535,21,29,4981200,754,373,381
1536,21,29,4981300,169,83,86
1537,21,29,4981400,1231,635,596
1538,21,29,4981500,0,0,0
1539,21,29,4981600,265,133,132
1540,21,29,4981700,577,293,284
1541,21,29,4981800,40,20,20
1542,21,29,4981900,351,163,188
1543,21,29,4982000,86,44,42
1544,21,29,4982100,90,44,46
1545,21,29,4982200,121,50,71
1546,21,29,4982300,47,20,27
1547,21,29,4982400,144,68,76
1548,21,29,4982500,570,293,277
1549,21,29,4982600,96,49,47
1550,21,29,4982700,864,424,440
1551,21,29,4982800,469,235,234
1552,21,29,4982900,121,67,54
1553,21,29,4983000,1281,630,651
1554,21,29,4983100,7000,3362,3638
1555,21,29,4983200,2210,1091,1119
1556,21,29,4983300,417,215,202
1557,21,29,4983400,354,173,181
1558,21,29,4983500,817,391,426
1559,21,29,4983600,524,270,254
1560,21,29,4983700,0,0,0
1561,21,29,4983800,0,0,0
1562,21,29,4983900,2,1,1
1563,21,29,4984000,392,192,200
1564,21,29,4984100,163,79,84
1565,21,29,4984200,429,200,229
1566,21,29,4984300,29,13,16
1567,21,29,4984400,113,53,60
1568,21,29,4984500,264,128,136
1569,21,29,4984600,0,0,0
1570,21,29,4984700,2339,1131,1208
1571,21,29,4984800,313,152,161
1572,21,29,4984900,227,110,117
1573,21,29,4985000,368,183,185
1574,21,29,4985100,447,216,231
1575,21,29,4985200,942,498,444
1576,21,29,4985300,323,153,170
1577,21,29,4985400,618,324,294
1578,21,29,4985500,963,475,488
1579,21,29,4985600,666,315,351
1580,21,29,4985700,1960,1074,886
1581,21,29,4985800,741,357,384
1582,21,29,4985900,460,237,223
1583,21,29,4986000,261,128,133
1584,21,29,4986100,213,103,110
1585,21,29,4986200,2737,1346,1391
1586,21,29,4986300,204,102,102
1587,21,29,4986400,1659,842,817
1588,21,29,4986500,97,48,49
1589,21,29,4986600,311,141,170
1590,21,29,4986700,0,0,0
1591,21,29,4986800,297,148,149
1592,21,29,4986900,258,143,115
1593,21,29,4987000,234,113,121
1594,21,29,4987100,277,143,134
1595,21,29,4987200,191,103,88
1596,21,29,4987300,104,43,61
1597,21,29,4987400,2784,1469,1315
1598,21,29,4987500,306,159,147
1599,21,29,4987600,270,127,143
1600,21,29,4987700,538,272,266
1601,21,29,4987800,1026,523,503
1602,21,29,4987900,374,168,206
1603,21,29,4988000,347,165,182
1604,21,29,4988100,153,67,86
1605,21,29,4988200,646,323,323
1606,21,29,4988300,0,0,0
1607,21,29,4988400,1580,773,807
1608,21,29,4988500,3783,1856,1927
1609,21,29,4988600,184,81,103
1610,21,29,4988700,812,452,360
1611,21,29,4988800,1281,646,635
1612,21,29,4988900,844,423,421
1613,21,29,4989000,508,239,269
1614,21,29,4989100,345,165,180
1615,21,29,4989200,384,171,213
1616,21,29,4989300,487,244,243
1617,21,29,4989400,594,325,269
1618,21,29,4989500,59,34,25
1619,21,29,4989600,152,76,76
1620,21,29,4989700,182,90,92
1621,21,29,4989800,73,36,37
1622,21,29,4989900,248,120,128
1623,21,29,4990000,137,65,72
1624,21,29,4990100,118,56,62
1625,21,29,4990200,398,205,193
1626,21,29,4990300,1221,576,645
1627,21,29,4990400,981,476,505
1628,21,29,4990500,1064,546,518
1629,21,29,4990600,569,290,279
1630,21,29,4990700,239,104,135
1631,21,29,4990800,827,401,426
1632,21,29,4990900,432,212,220
1633,21,29,4991000,2157,1106,1051
1634,21,29,4991100,815,377,438
1635,21,29,4991200,3637,1879,1758
1636,21,29,4991300,1673,796,877
1637,21,29,4991400,661,333,328
1638,21,29,4991500,0,0,0
1639,21,29,4991600,474,220,254
1640,21,29,4991700,231,119,112
1641,21,29,4991800,42,18,24
1642,21,29,4991900,0,0,0
1643,21,29,4992000,169,80,89
1644,21,29,4992100,246,133,113
1645,21,29,4992200,99,59,40
1646,21,29,4992300,177,90,87
1647,21,29,4992400,190,89,101
1648,21,29,4992500,43,25,18
1649,21,29,4992600,98,50,48
1650,21,29,4992700,429,222,207
1651,21,29,4992800,183,86,97
1652,21,29,4992900,234,107,127
1653,21,29,4993000,215,111,104
1654,21,29,4993100,253,128,125
1655,21,29,4993200,66,34,32
1656,21,29,4993300,3254,1670,1584
1657,21,29,4993400,283,136,147
1658,21,29,4993500,223,120,103
1659,21,29,4993600,241,117,124
1660,21,29,4993700,197,97,100
1661,21,29,4993800,171,88,83
1662,21,29,4993900,308,171,137
1663,21,29,4994000,220,111,109
1664,21,29,4994100,168,84,84
1665,21,29,4994200,174,86,88
1666,21,29,4994300,270,132,138
1667,21,29,4994400,476,224,252
1668,21,29,4994500,257,119,138
1669,21,29,4994600,168,84,84
1670,21,29,4994700,42,18,24
1671,21,29,4994800,78,39,39
1672,21,29,4994900,2180,1006,1174
1673,21,29,4995000,1326,679,647
1674,21,29,4995100,321,150,171
1675,21,29,4995200,0,0,0
1676,21,29,4995300,870,416,454
1677,21,29,4995400,1906,958,948
1678,21,29,4995500,0,0,0
1679,21,29,4995600,361,188,173
1680,21,29,4995700,545,282,263
1681,21,29,4995800,1315,635,680
1682,21,29,4995900,273,121,152
1683,21,29,4996000,344,163,181
1684,21,29,4996100,552,260,292
1685,21,29,4996200,586,284,302
1686,21,29,4996300,787,401,386
1687,21,29,4996400,409,191,218
1688,21,29,4996500,174,81,93
1689,21,29,4996600,1114,530,584
1690,21,29,4996700,90,45,45
1691,21,29,4996800,113,52,61
1692,21,29,4996900,389,189,200
1693,21,29,4997000,679,363,316
1694,21,29,4997100,2318,1161,1157
1695,21,29,4997200,945,452,493
1696,21,29,4997300,1537,775,762
1697,21,29,4997400,91,44,47
1698,21,29,4997500,291,151,140
1699,21,29,4997600,285,146,139
1700,21,29,4997700,197,105,92
1701,21,29,4997800,222,98,124
1702,21,29,4997900,81,37,44
1703,21,29,4998000,327,150,177
1704,21,29,4998100,104,48,56
1705,21,29,4998200,246,128,118
1706,21,29,4998300,315,153,162
1707,21,29,4998400,219,118,101
1708,21,29,4998500,231,106,125
1709,21,29,4998600,3266,1648,1618
1710,21,29,4998700,1647,870,777
1711,21,29,4998800,227,122,105
1712,21,29,4998900,76,39,37
1713,21,29,4999000,431,226,205
1714,21,29,4999100,439,211,228
1715,21,29,4999200,311,158,153
1716,21,29,4999300,316,160,156
1717,21,29,4999400,121,66,55
1718,21,29,4999500,164,80,84
1719,21,29,4999600,86,44,42
1720,21,29,4999700,268,142,126
1721,21,29,4999800,285,150,135
1722,21,29,4999900,513,261,252
1723,21,29,5000000,573,273,300
1724,21,29,5000100,1315,671,644
1725,21,29,5000200,257,126,131
1726,21,29,5000300,593,281,312
1727,21,29,5000400,76,45,31
1728,21,29,5000500,96,50,46
1729,21,29,5000600,128,67,61
1730,21,29,5000700,319,144,175
1731,21,29,5000800,941,501,440
1732,21,29,5000900,404,208,196
1733,21,29,5001000,568,296,272
1734,21,29,5001100,547,254,293
1735,21,29,5001200,397,200,197
1736,21,29,5001300,153,71,82
1737,21,29,5001400,297,150,147
1738,21,29,5001500,262,133,129
1739,21,29,5001600,300,141,159
1740,21,29,5001700,748,365,383
1741,21,29,5001800,642,313,329
1742,21,29,5001900,857,417,440
1743,21,29,5002000,1488,712,776
1744,21,29,5002100,2071,1026,1045
1745,21,29,5002200,94,39,55
1746,21,29,5002300,53,26,27
1747,21,29,5002400,58,29,29
1748,21,29,5002500,84,44,40
1749,21,29,5002600,111,48,63
1750,21,29,5002700,121,59,62
1751,21,29,5002800,188,91,97
1752,21,29,5002900,78,36,42
1753,21,29,5003000,221,97,124
1754,21,29,5003100,132,58,74
1755,21,29,5003200,58,27,31
1756,21,29,5003300,80,47,33
1757,21,29,5003400,79,48,31
1758,21,29,5003500,812,409,403
1759,21,29,5003600,239,128,111
1760,21,29,5003700,58,27,31
1761,21,29,5003800,460,248,212
1762,21,29,5003900,111,60,51
1763,21,29,5004000,90,49,41
1764,21,29,5004100,88,44,44
1765,21,29,5004200,87,47,40
1766,21,29,5004300,140,67,73
1767,21,29,5004400,366,187,179
1768,21,29,5004500,192,107,85
1769,21,29,5004600,283,141,142
1770,21,29,5004700,122,48,74
1771,21,29,5004800,195,107,88
1772,21,29,5004900,142,76,66
1773,21,29,5005000,197,98,99
1774,21,29,5005100,330,153,177
1775,21,29,5005200,60,32,28
1776,21,29,5005300,37,19,18
1777,21,29,5005400,56,33,23
1778,21,29,5005500,73,39,34
1779,21,29,5005600,112,55,57
1780,21,29,5005700,94,53,41
1781,21,29,5005800,55,32,23
1782,21,29,5005900,349,184,165
1783,21,29,5006000,367,160,207
1784,21,29,5006100,523,275,248
1785,21,29,5006200,775,375,400
1786,21,29,5006300,221,117,104
1787,21,29,5006400,468,244,224
1788,21,29,5006500,28,16,12
1789,21,29,5006600,103,49,54
1790,21,29,5006700,58,28,30
1791,21,29,5006800,143,78,65
1792,21,29,5006900,104,59,45
1793,21,29,5007000,0,0,0
1794,21,29,5007100,28,12,16
1795,21,29,5007200,149,68,81
1796,21,29,5007300,58,32,26
1797,21,29,5007400,127,67,60
1798,21,29,5007500,96,52,44
1799,21,29,5007600,127,57,70
1800,21,29,5007700,88,29,59
1801,21,29,5007800,20,11,9
1802,21,29,5007900,183,67,116
1803,21,29,5008000,0,0,0
1804,21,29,5008100,65,29,36
1805,21,29,5008200,243,126,117
1806,21,29,5008300,149,73,76
1807,21,29,5008400,0,0,0
1808,21,29,5008500,0,0,0
1809,21,29,5008600,0,0,0
1810,21,29,5008700,0,0,0
1811,21,29,5008800,0,0,0
1812,21,29,5008900,0,0,0
1813,21,29,5009000,102,52,50
1814,21,29,5009100,137,58,79
1815,21,29,5009200,235,104,131
1816,21,29,5009300,137,73,64
1817,21,29,5009400,39,19,20
1818,21,29,5009500,0,0,0
1819,21,29,5009600,0,0,0
1820,21,29,5009700,0,0,0
1821,21,29,5009800,107,48,59
1822,21,29,5009900,0,0,0
1823,21,29,5010000,0,0,0
1824,21,29,5010100,0,0,0
1825,21,29,5010200,0,0,0
1826,21,29,5010300,118,49,69
1827,21,29,5010400,148,75,73
1828,21,29,5010500,99,49,50
1829,21,29,5010600,121,60,61
1830,21,29,5010700,35,16,19
1831,21,29,5010800,0,0,0
1832,21,29,5010900,53,25,28
1833,21,29,5011000,40,19,21
1834,21,29,5011100,60,33,27
1835,21,29,5011200,66,25,41
1836,21,29,5011300,73,34,39
1837,21,29,5011400,60,26,34
1838,21,29,5011500,80,40,40
1839,21,29,5011600,19,5,14
1840,21,29,5011700,66,34,32
1841,21,29,5011800,48,19,29
1842,21,29,5011900,36,16,20
1843,21,29,5012000,19,9,10
1844,21,29,5012100,95,48,47
1845,21,29,5012200,35,19,16
1846,21,29,5012300,260,129,131
1847,21,29,5012400,90,47,43
1848,21,29,5012500,58,25,33
1849,21,29,5012600,36,18,18
1850,21,29,5012700,18,9,9
1851,21,29,5012800,106,55,51
1852,21,29,5012900,98,50,48
1853,21,29,5013000,60,33,27
1854,21,29,5013100,161,86,75
1855,21,29,5013200,32,17,15
1856,21,29,5013300,45,20,25
1857,21,29,5013400,133,65,68
1858,21,29,5013500,171,79,92
1859,21,29,5013600,52,27,25
1860,21,29,5013700,960,478,482
1861,21,29,5013800,7218,3596,3622
1862,21,29,5013900,910,455,455
1863,21,29,5014000,576,308,268
1864,21,29,5014100,423,200,223
1865,21,29,5014200,847,423,424
1866,21,29,5014300,957,467,490
1867,21,29,5014400,324,155,169
1868,21,29,5014500,321,152,169
1869,21,29,5014600,219,99,120
1870,21,29,5014700,1679,816,863
1871,21,29,5014800,3674,1903,1771
1872,21,29,5014900,1469,717,752
1873,21,29,5015000,1617,860,757
1874,21,29,5015100,309,167,142
1875,21,29,5015200,767,360,407
1876,21,29,5015300,532,253,279
1877,21,29,5015400,1341,689,652
1878,21,29,5015500,1262,646,616
1879,21,29,5015600,414,211,203
1880,21,29,5015700,112,63,49
1881,21,29,5015800,1297,646,651
1882,21,29,5015900,664,316,348
1883,21,29,5016000,1385,692,693
1884,21,29,5016100,1419,727,692
1885,21,29,5016200,55,29,26
1886,21,29,5016300,564,258,306
1887,21,29,5016400,325,155,170
1888,21,29,5016500,235,110,125
1889,21,29,5016600,657,330,327
1890,21,29,5016700,974,491,483
1891,21,29,5016800,311,159,152
1892,21,29,5016900,583,314,269
1893,21,29,5017000,2690,1357,1333
1894,21,29,5017100,1305,672,633
1895,21,29,5017200,873,430,443
1896,21,29,5017300,0,0,0
1897,21,29,5017400,2758,1418,1340
1898,21,29,5017500,516,280,236
1899,21,29,5017600,2582,1290,1292
1900,21,29,5017700,293,151,142
1901,21,29,5017800,0,0,0
1902,21,29,5017900,2333,1213,1120
1903,21,29,5018000,4131,2079,2052
1904,21,29,5018100,413,205,208
1905,21,29,5018200,291,153,138
1906,21,29,5018300,311,141,170
1907,21,29,5018400,1403,717,686
1908,21,29,5018500,226,103,123
1909,21,29,5018600,661,339,322
1910,21,29,5018700,588,291,297
1911,21,29,5018800,370,174,196
1912,21,29,5018900,429,206,223
1913,21,29,5019000,1317,627,690
1914,21,29,5019100,747,347,400
1915,21,29,5019200,2381,1189,1192
1916,21,29,5019300,1791,881,910
1917,21,29,5019400,495,239,256
1918,21,29,5019500,0,0,0
1919,21,29,5019600,4810,2433,2377
1920,21,29,5019700,689,340,349
1921,21,29,5019800,0,0,0
1922,21,29,5019900,1655,807,848
1923,21,29,5020000,0,0,0
1924,21,29,5020100,793,377,416
1925,21,29,5020200,1000,498,502
1926,21,29,5020300,444,204,240
1927,21,29,5020400,293,148,145
1928,21,29,5020500,616,291,325
1929,21,29,5020600,296,150,146
1930,21,29,5020700,2284,1058,1226
1931,21,29,5020800,222,111,111
1932,21,29,5020900,4651,2385,2266
1933,21,29,5021000,2470,1273,1197
1934,21,29,5021100,2761,1414,1347
1935,21,29,5021200,0,0,0
1936,21,29,5021300,2334,1160,1174
1937,21,29,5021400,3624,1897,1727
1938,21,29,5021500,561,270,291
1939,21,29,5021600,1564,754,810
1940,21,29,5021700,189,99,90
1941,21,29,5021800,0,0,0
1942,21,29,5021900,685,329,356
1943,21,29,5022000,439,207,232
1944,21,29,5022100,105,57,48
1945,21,29,5022200,694,328,366
1946,21,29,5022300,693,360,333
1947,21,29,5022400,773,370,403
1948,21,29,5022500,1124,554,570
1949,21,29,5022600,305,141,164
1950,21,29,5022700,324,158,166
1951,21,29,5022800,421,206,215
1952,21,29,5022900,292,141,151
1953,21,29,5023000,234,121,113
1954,21,29,5023100,311,141,170
1955,21,29,5023200,1006,505,501
1956,21,29,5023300,1073,530,543
1957,21,29,5023400,235,121,114
1958,21,29,5023500,0,0,0
1959,21,29,5023600,840,417,423
1960,21,29,5023700,316,153,163
1961,21,29,5023800,763,370,393
1962,21,29,5023900,1342,684,658
1963,21,29,5024000,1978,992,986
1964,21,29,5024100,165,83,82
1965,21,29,5024200,1208,616,592
1966,21,29,5024300,694,344,350
1967,21,29,5024400,904,432,472
1968,21,29,5024500,167,87,80
1969,21,29,5024600,502,266,236
1970,21,29,5024700,1333,704,629
1971,21,29,5024800,428,212,216
1972,21,29,5024900,1652,819,833
1973,21,29,5025000,1175,611,564
1974,21,29,5025100,1054,522,532
1975,21,29,5025200,672,345,327
1976,21,29,5025300,198,106,92
1977,21,29,5025400,1305,630,675
1978,21,29,5025500,366,174,192
1979,21,29,5025600,615,304,311
1980,21,29,5025700,373,172,201
1981,21,29,5025800,120,50,70
1982,21,29,5025900,229,112,117
1983,21,29,5026000,285,142,143
1984,21,29,5026100,64,33,31
1985,21,29,5026200,167,87,80
1986,21,29,5026300,165,78,87
1987,21,29,5026400,874,429,445
1988,21,29,5026500,149,75,74
1989,21,29,5026600,289,144,145
1990,21,29,5026700,282,134,148
1991,21,29,5026800,168,84,84
1992,21,29,5026900,89,42,47
1993,21,29,5027000,226,105,121
1994,21,29,5027100,146,76,70
1995,21,29,5027200,1972,959,1013
1996,21,29,5027300,1504,777,727
1997,21,29,5027400,5852,2908,2944
1998,21,29,5027500,1308,670,638
1999,21,29,5027600,1083,560,523
2000,21,29,5027700,2086,1046,1040
2001,21,29,5027800,1138,568,570
2002,21,29,5027900,1054,547,507
2003,21,29,5028000,179,97,82
2004,21,29,5028100,2458,1205,1253
2005,21,29,5028200,632,311,321
2006,21,29,5028300,474,248,226
2007,21,29,5028400,944,469,475
2008,21,29,5028500,448,220,228
2009,21,29,5028600,506,230,276
2010,21,29,5028700,3799,1924,1875
2011,21,29,5028800,1116,562,554
2012,21,29,5028900,336,172,164
2013,21,29,5029000,146,73,73
2014,21,29,5029100,213,112,101
2015,21,29,5029200,104,56,48
2016,21,29,5029300,316,161,155
2017,21,29,5029400,187,98,89
2018,21,29,5029500,2999,1477,1522
2019,21,29,5029600,397,198,199
2020,21,29,5029700,3304,1601,1703
2021,21,29,5029800,642,325,317
2022,21,29,5029900,484,273,211
2023,21,29,5030000,1058,523,535
2024,21,29,5030100,1512,724,788
2025,21,29,5030200,475,220,255
2026,21,29,5030300,121,63,58
2027,21,29,5030400,2571,1275,1296
